"","SubjectNumber","Trial","LeftRight","RT","FoodLeft","FoodRight","ValueLeft","ValueRight","PreviousEncounterLeft","PreviousEncounterRight","PreviousEncounterBoth","PreviousEncounterChosen","pe.median","Familiarity","vdiff","difficulty"
"1",1,1,0,2.972,63,112,6,6,0,0,0,0,3,"Low",0,0
"2",1,2,1,2.2836,57,123,4,5,0,0,0,0,3,"Low",-1,1
"3",1,3,0,3.6888,82,9,4,5,0,0,0,0,3,"Low",-1,1
"4",1,4,1,3.4532,111,128,5,5,0,0,0,0,3,"Low",0,0
"5",1,5,0,2.0578,79,98,7,6,0,0,0,0,3,"Low",1,1
"6",1,6,1,7.9724,41,39,7,2,0,0,0,0,3,"Low",5,5
"7",1,7,1,3.7311,76,35,5,5,0,0,0,0,3,"Low",0,0
"8",1,8,1,1.3474,87,93,4,5,0,0,0,0,3,"Low",-1,1
"9",1,9,1,2.0749,36,49,5,2,0,0,0,0,3,"Low",3,3
"10",1,10,0,2.8294,90,48,3,6,0,0,0,0,3,"Low",-3,3
"11",1,11,1,3.5171,94,125,5,3,0,0,0,0,3,"Low",2,2
"12",1,12,1,3.2218,98,116,6,4,1,0,1,1,3,"Low",2,2
"13",1,13,1,1.2653,132,114,7,7,0,0,0,0,3,"Low",0,0
"14",1,14,0,0.99778,108,41,4,7,0,1,1,1,3,"Low",-3,3
"15",1,15,0,3.0139,37,120,1,4,0,0,0,0,3,"Low",-3,3
"16",1,16,0,1.0835,40,132,2,7,0,1,1,1,3,"Low",-5,5
"17",1,17,1,1.7012,73,131,4,4,0,0,0,0,3,"Low",0,0
"18",1,18,0,2.0155,100,98,5,6,0,2,2,2,3,"Low",-1,1
"19",1,19,1,1.2076,137,106,6,2,0,0,0,0,3,"Low",4,4
"20",1,20,1,1.9404,6,26,5,3,0,0,0,0,3,"Low",2,2
"21",1,21,0,2.0503,120,85,4,4,1,0,1,0,3,"Low",0,0
"22",1,22,0,9.1734,80,69,5,5,0,0,0,0,3,"Low",0,0
"23",1,23,1,3.2139,117,108,5,4,0,1,1,0,3,"Low",1,1
"24",1,24,0,1.9586,125,128,3,5,1,1,2,1,3,"Low",-2,2
"25",1,25,1,4.19,31,117,5,5,0,1,1,0,3,"Low",0,0
"26",1,26,0,2.3055,137,9,6,5,1,1,2,1,3,"Low",1,1
"27",1,27,0,1.11,70,32,5,7,0,0,0,0,3,"Low",-2,2
"28",1,28,0,3.3936,112,1,6,6,1,0,1,0,3,"Low",0,0
"29",1,29,0,3.6909,94,96,5,6,1,0,1,0,3,"Low",-1,1
"30",1,30,0,1.0542,99,144,6,7,0,0,0,0,3,"Low",-1,1
"31",1,31,0,1.1957,125,27,3,7,2,0,2,0,3,"Low",-4,4
"32",1,32,0,5.2075,124,128,7,5,0,2,2,2,3,"Low",2,2
"33",1,33,1,1.7197,21,7,7,6,0,0,0,0,3,"Low",1,1
"34",1,34,1,1.9139,31,116,5,4,1,1,2,1,3,"Low",1,1
"35",1,35,1,1.2075,27,14,7,6,1,0,1,1,3,"Low",1,1
"36",1,36,0,2.2316,35,73,5,4,1,1,2,1,3,"Low",1,1
"37",1,37,1,2.2755,112,137,6,6,2,2,4,2,3,"High",0,0
"38",1,38,1,1.2394,57,147,4,4,1,0,1,1,3,"Low",0,0
"39",1,39,0,1.079,11,124,3,7,0,1,1,1,3,"Low",-4,4
"40",1,40,0,1.4667,13,101,4,7,0,0,0,0,3,"Low",-3,3
"41",1,41,0,2.5178,58,9,4,5,0,2,2,2,3,"Low",-1,1
"42",1,42,1,5.2896,121,47,7,6,0,0,0,0,3,"Low",1,1
"43",1,43,1,1.2597,51,26,6,3,0,1,1,0,3,"Low",3,3
"44",1,44,0,1.4152,110,25,4,4,0,0,0,0,3,"Low",0,0
"45",1,45,1,2.3399,4,30,7,4,0,0,0,0,3,"Low",3,3
"46",1,46,0,1.4726,67,1,2,6,0,1,1,1,3,"Low",-4,4
"47",1,47,1,1.0293,104,145,7,4,0,0,0,0,3,"Low",3,3
"48",1,48,1,1.4963,62,89,6,4,0,0,0,0,3,"Low",2,2
"49",1,49,1,3.3919,92,49,7,2,0,1,1,0,3,"Low",5,5
"50",1,50,0,2.8164,106,12,2,3,1,0,1,0,3,"Low",-1,1
"51",1,51,1,1.19,141,142,5,3,0,0,0,0,3,"Low",2,2
"52",1,52,0,7.0158,117,87,5,4,2,1,3,1,3,"Low",1,1
"53",1,53,1,1.4301,112,52,6,6,3,0,3,3,3,"Low",0,0
"54",1,54,0,1.1854,49,63,2,6,2,1,3,1,3,"Low",-4,4
"55",1,55,1,2.0593,139,38,6,4,0,0,0,0,3,"Low",2,2
"56",1,56,0,2.029,71,105,6,6,0,0,0,0,3,"Low",0,0
"57",1,57,0,2.2815,10,136,3,3,0,0,0,0,3,"Low",0,0
"58",1,58,0,1.9757,14,50,6,6,1,0,1,0,3,"Low",0,0
"59",1,59,1,1.7704,18,98,3,6,0,3,3,0,3,"Low",-3,3
"60",1,60,1,1.5591,111,77,5,6,1,0,1,1,3,"Low",-1,1
"61",1,61,0,1.5324,125,7,3,6,3,1,4,1,3,"High",-3,3
"62",1,62,1,1.1246,3,130,6,2,0,0,0,0,3,"Low",4,4
"63",1,63,1,1.3047,121,108,7,4,1,2,3,1,3,"Low",3,3
"64",1,64,0,2.2808,61,118,6,5,0,0,0,0,3,"Low",1,1
"65",1,65,0,1.6273,48,133,6,7,1,0,1,0,3,"Low",-1,1
"66",1,66,1,1.6479,62,142,6,3,1,1,2,1,3,"Low",3,3
"67",1,67,1,5.28,60,5,6,6,0,0,0,0,3,"Low",0,0
"68",1,68,0,1.4614,16,114,4,7,0,1,1,1,3,"Low",-3,3
"69",1,69,0,1.2298,38,140,4,8,1,0,1,0,3,"Low",-4,4
"70",1,70,0,4.4977,5,60,6,6,1,1,2,1,3,"Low",0,0
"71",1,71,1,1.4298,1,54,6,3,2,0,2,2,3,"Low",3,3
"72",1,72,0,2.7118,20,111,7,5,0,2,2,2,3,"Low",2,2
"73",1,73,0,1.1947,85,104,4,7,1,1,2,1,3,"Low",-3,3
"74",1,74,0,3.198,60,143,6,6,2,0,2,0,3,"Low",0,0
"75",1,75,1,1.3153,97,77,6,6,0,1,1,0,3,"Low",0,0
"76",1,76,1,2.696,60,47,6,6,3,1,4,3,3,"High",0,0
"77",1,77,1,1.0129,97,69,6,5,1,1,2,1,3,"Low",1,1
"78",1,78,1,1.3249,29,44,5,1,0,0,0,0,3,"Low",4,4
"79",1,79,0,3.9382,14,129,6,7,2,0,2,0,3,"Low",-1,1
"80",1,80,0,1.6994,30,20,4,7,1,1,2,1,3,"Low",-3,3
"81",1,81,0,2.2317,85,78,4,5,2,0,2,0,3,"Low",-1,1
"82",1,82,0,1.3825,12,96,3,6,1,1,2,1,3,"Low",-3,3
"83",1,83,0,1.54,58,14,4,6,1,3,4,3,3,"High",-2,2
"84",1,84,0,2.278,108,58,4,4,3,2,5,2,3,"High",0,0
"85",1,85,0,1.2288,13,111,4,5,1,3,4,3,3,"High",-1,1
"86",1,86,0,1.9454,48,118,6,5,2,1,3,1,3,"Low",1,1
"87",1,87,0,3.1746,7,118,6,5,2,2,4,2,3,"High",1,1
"88",1,88,1,2.5849,98,124,6,7,4,2,6,4,3,"High",-1,1
"89",1,89,0,2.0883,47,87,6,4,2,2,4,2,3,"High",2,2
"90",1,90,0,1.8495,84,63,5,6,0,2,2,2,3,"Low",-1,1
"91",1,91,1,1.9742,14,61,6,6,4,1,5,4,3,"High",0,0
"92",1,92,0,2.6582,84,63,5,6,1,3,4,3,3,"High",-1,1
"93",1,93,1,1.1183,32,94,7,5,1,2,3,1,3,"Low",2,2
"94",1,94,0,0.76259,120,139,4,6,2,1,3,1,3,"Low",-2,2
"95",1,95,0,2.2526,120,79,4,7,3,1,4,1,3,"High",-3,3
"96",1,96,0,2.4351,80,21,5,7,1,1,2,1,3,"Low",-2,2
"97",1,97,0,2.2461,81,34,3,4,0,0,0,0,3,"Low",-1,1
"98",1,98,0,1.2188,13,93,4,5,2,1,3,1,3,"Low",-1,1
"99",1,99,0,1.488,36,101,5,7,1,1,2,1,3,"Low",-2,2
"100",1,100,1,2.3441,30,8,4,6,2,0,2,2,3,"Low",-2,2
"101",1,101,0,1.207,54,45,3,6,1,0,1,0,3,"Low",-3,3
"102",1,102,0,0.99509,11,101,3,7,1,2,3,2,3,"Low",-4,4
"103",1,103,1,1.0824,94,106,5,2,3,2,5,3,3,"High",3,3
"104",1,104,1,2.0019,73,25,4,4,2,1,3,2,3,"Low",0,0
"105",1,105,0,3.2918,120,11,4,3,4,2,6,2,3,"High",1,1
"106",1,106,1,1.052,18,106,3,2,1,3,4,1,3,"High",1,1
"107",1,107,1,1.8852,57,115,4,6,2,0,2,2,3,"Low",-2,2
"108",1,108,0,2.1922,26,99,3,6,2,1,3,1,3,"Low",-3,3
"109",1,109,1,2.8287,60,67,6,2,4,1,5,4,3,"High",4,4
"110",1,110,0,1.6107,131,114,4,7,1,2,3,2,3,"Low",-3,3
"111",1,111,1,2.3337,21,73,7,4,2,3,5,2,3,"High",3,3
"112",1,112,1,2.683,63,93,6,5,4,2,6,4,3,"High",1,1
"113",1,113,1,2.261,31,113,5,5,2,0,2,2,3,"Low",0,0
"114",1,114,1,4.5616,66,118,8,5,0,3,3,0,3,"Low",3,3
"115",1,115,1,1.0566,27,132,7,7,2,2,4,2,3,"High",0,0
"116",1,116,1,1.4585,113,37,5,1,1,1,2,1,3,"Low",4,4
"117",1,117,1,1.3353,87,46,4,7,3,0,3,3,3,"Low",-3,3
"118",1,118,1,1.4847,121,70,7,5,2,1,3,2,3,"Low",2,2
"119",1,119,1,1.0573,31,113,5,5,3,2,5,3,3,"High",0,0
"120",1,120,0,1.1299,45,65,6,7,1,0,1,0,3,"Low",-1,1
"121",1,121,0,1.3747,147,31,4,5,1,4,5,4,3,"High",-1,1
"122",1,122,0,2.2495,126,115,5,6,0,1,1,1,3,"Low",-1,1
"123",1,123,1,0.84488,62,77,6,6,2,2,4,2,3,"High",0,0
"124",1,124,1,1.6582,76,85,5,4,1,3,4,1,3,"High",1,1
"125",1,125,0,2.0038,108,70,4,5,4,2,6,2,3,"High",-1,1
"126",1,126,0,1.1897,69,50,5,6,2,1,3,1,3,"Low",-1,1
"127",1,127,1,1.355,74,37,6,1,0,2,2,0,3,"Low",5,5
"128",1,128,0,1.3391,48,143,6,6,3,1,4,1,3,"High",0,0
"129",1,129,0,1.1272,82,133,4,7,1,1,2,1,3,"Low",-3,3
"130",1,130,1,1.1087,66,82,8,4,1,2,3,1,3,"Low",4,4
"131",1,131,1,2.0119,36,142,5,3,2,2,4,2,3,"High",2,2
"132",1,132,1,1.1112,65,82,7,4,1,3,4,1,3,"High",3,3
"133",1,133,1,1.0756,4,40,7,2,1,1,2,1,3,"Low",5,5
"134",1,134,1,1.6049,137,38,6,4,3,2,5,3,3,"High",2,2
"135",1,135,1,2.2375,99,126,6,5,2,1,3,2,3,"Low",1,1
"136",1,136,1,1.351,115,142,6,3,2,3,5,2,3,"High",3,3
"137",1,137,0,1.1525,39,69,2,5,1,3,4,3,3,"High",-3,3
"138",1,138,1,2.0445,68,12,6,3,0,2,2,0,3,"Low",3,3
"139",1,139,1,1.392,5,147,6,4,2,2,4,2,3,"High",2,2
"140",1,140,1,1.2627,101,110,7,4,3,1,4,3,3,"High",3,3
"141",1,141,1,1.0812,96,77,6,6,2,3,5,2,3,"High",0,0
"142",1,142,1,1.6822,101,142,7,3,4,4,8,4,3,"High",4,4
"143",1,143,0,2.1201,12,82,3,4,3,4,7,4,3,"High",-1,1
"144",1,144,1,1.3794,83,68,6,6,0,1,1,0,3,"Low",0,0
"145",1,145,1,1.0124,96,10,6,3,3,1,4,3,3,"High",3,3
"146",1,146,1,2.2516,139,123,6,5,2,1,3,2,3,"Low",1,1
"147",1,147,1,2.2212,32,2,7,6,2,0,2,2,3,"Low",1,1
"148",1,148,1,1.5745,92,8,7,6,1,1,2,1,3,"Low",1,1
"149",1,149,0,2.7191,100,74,5,6,1,1,2,1,3,"Low",-1,1
"150",1,150,0,3.7514,44,67,1,2,1,2,3,2,3,"Low",-1,1
"151",1,151,1,2.6415,73,124,4,7,4,3,7,4,3,"High",-3,3
"152",1,152,1,0.89902,5,44,6,1,3,2,5,3,3,"High",5,5
"153",1,153,1,1.0136,68,40,6,2,2,2,4,2,3,"High",4,4
"154",1,154,1,2.5208,11,136,3,3,3,1,4,3,3,"High",0,0
"155",1,155,0,1.2211,113,16,5,4,3,1,4,1,3,"High",1,1
"156",1,156,0,4.9697,76,141,5,5,2,1,3,1,3,"Low",0,0
"157",1,157,1,0.75401,27,9,7,5,3,3,6,3,3,"High",2,2
"158",1,158,0,1.4459,67,20,2,7,3,2,5,2,3,"High",-5,5
"159",1,159,1,1.5638,5,90,6,3,4,1,5,4,3,"High",3,3
"160",1,160,1,1.2648,68,113,6,5,3,4,7,3,3,"High",1,1
"161",1,161,1,0.97915,104,105,7,6,2,1,3,2,3,"Low",1,1
"162",1,162,1,1.6089,96,147,6,4,4,3,7,4,3,"High",2,2
"163",1,163,0,1.2087,38,1,4,6,3,3,6,3,3,"High",-2,2
"164",1,164,1,1.98,53,107,4,3,0,0,0,0,3,"Low",1,1
"165",1,165,0,2.5409,80,87,5,4,2,4,6,4,3,"High",1,1
"166",1,166,0,1.9837,85,91,4,6,4,0,4,0,3,"High",-2,2
"167",1,167,1,4.1589,2,32,6,7,1,3,4,1,3,"High",-1,1
"168",1,168,1,1.5519,112,40,6,2,4,3,7,4,3,"High",4,4
"169",1,169,0,5.876,41,50,7,6,2,2,4,2,3,"High",1,1
"170",1,170,1,1.5144,77,116,6,4,4,2,6,4,3,"High",2,2
"171",1,171,1,1.3174,21,124,7,7,3,4,7,3,3,"High",0,0
"172",1,172,0,1.5522,131,21,4,7,2,4,6,4,3,"High",-3,3
"173",1,173,1,1.8548,141,94,5,5,2,4,6,2,3,"High",0,0
"174",1,174,1,1.6322,50,106,6,2,3,4,7,3,3,"High",4,4
"175",1,175,0,2.1934,46,91,7,6,1,1,2,1,3,"Low",1,1
"176",1,176,1,0.96103,110,19,4,5,2,0,2,2,3,"Low",-1,1
"177",1,177,0,1.1256,13,47,4,6,3,3,6,3,3,"High",-2,2
"178",1,178,0,0.70735,80,143,5,6,3,2,5,2,3,"High",-1,1
"179",1,179,0,2.2972,10,114,3,7,2,3,5,3,3,"High",-4,4
"180",1,180,0,1.2152,130,49,2,2,1,3,4,3,3,"High",0,0
"181",1,181,0,0.83534,39,57,2,4,2,3,5,3,3,"High",-2,2
"182",1,182,1,3.4785,92,111,7,5,2,4,6,2,3,"High",2,2
"183",1,183,0,1.3063,49,26,2,3,4,3,7,3,3,"High",-1,1
"184",1,184,0,1.5387,16,55,4,6,2,0,2,0,3,"Low",-2,2
"185",1,185,1,1.0673,62,116,6,4,3,3,6,3,3,"High",2,2
"186",1,186,1,1.9595,45,36,6,5,2,3,5,2,3,"High",1,1
"187",1,187,1,1.411,20,125,7,3,3,4,7,3,3,"High",4,4
"188",1,188,1,0.82833,104,143,7,6,3,3,6,3,3,"High",1,1
"189",1,189,1,3.2862,84,45,5,6,2,3,5,2,3,"High",-1,1
"190",1,190,1,1.7092,144,139,7,6,1,3,4,1,3,"High",1,1
"191",1,191,0,3.3426,137,70,6,5,4,3,7,3,3,"High",1,1
"192",1,192,0,1.7241,30,46,4,7,3,2,5,2,3,"High",-3,3
"193",1,193,0,1.234,81,76,3,5,1,3,4,3,3,"High",-2,2
"194",1,194,1,0.92585,139,13,6,4,4,4,8,4,3,"High",2,2
"195",1,195,0,0.88849,11,3,3,6,4,1,5,1,3,"High",-3,3
"196",1,196,0,1.1708,80,144,5,7,4,2,6,2,3,"High",-2,2
"197",1,197,1,1.0595,89,12,4,3,1,4,5,1,3,"High",1,1
"198",1,198,0,2.329,29,84,5,5,1,3,4,3,3,"High",0,0
"199",1,199,1,1.8589,25,89,4,4,2,2,4,2,3,"High",0,0
"200",1,200,1,1.2693,97,32,6,7,2,4,6,2,3,"High",-1,1
"201",2,1,0,0.92194,87,116,10,10,0,0,0,0,4,"Low",0,0
"202",2,2,1,1.2551,141,97,1,3,0,0,0,0,4,"Low",-2,2
"203",2,3,0,1.1047,91,146,1,2,0,0,0,0,4,"Low",-1,1
"204",2,4,1,1.9854,139,50,3,2,0,0,0,0,4,"Low",1,1
"205",2,5,1,1.2658,114,127,1,1,0,0,0,0,4,"Low",0,0
"206",2,6,1,1.2125,39,138,1,1,0,0,0,0,4,"Low",0,0
"207",2,7,1,1.0147,41,140,3,1,0,0,0,0,4,"Low",2,2
"208",2,8,1,1.7147,17,98,2,1,0,0,0,0,4,"Low",1,1
"209",2,9,1,2.1534,102,54,3,3,0,0,0,0,4,"Low",0,0
"210",2,10,1,1.5915,31,34,2,1,0,0,0,0,4,"Low",1,1
"211",2,11,1,1.9891,73,140,1,1,0,1,1,0,4,"Low",0,0
"212",2,12,0,1.0256,50,104,2,7,1,0,1,0,4,"Low",-5,5
"213",2,13,0,0.87553,39,41,1,3,1,1,2,1,4,"Low",-2,2
"214",2,14,1,1.5006,73,143,1,1,1,0,1,1,4,"Low",0,0
"215",2,15,0,1.1257,112,85,1,4,0,0,0,0,4,"Low",-3,3
"216",2,16,0,1.3989,138,34,1,1,1,1,2,1,4,"Low",0,0
"217",2,17,1,4.5089,127,21,1,2,1,0,1,1,4,"Low",-1,1
"218",2,18,1,1.0871,100,17,3,2,0,1,1,0,4,"Low",1,1
"219",2,19,0,1.2418,50,146,2,2,2,1,3,1,4,"Low",0,0
"220",2,20,0,1.8407,39,121,1,2,2,0,2,0,4,"Low",-1,1
"221",2,21,1,1.3719,119,85,9,4,0,1,1,0,4,"Low",5,5
"222",2,22,0,0.60925,65,146,2,2,0,2,2,2,4,"Low",0,0
"223",2,23,0,2.5247,90,138,1,1,0,2,2,2,4,"Low",0,0
"224",2,24,1,2.0576,112,50,1,2,1,3,4,1,4,"Low",-1,1
"225",2,25,0,1.326,17,97,2,3,2,1,3,1,4,"Low",-1,1
"226",2,26,0,1.0382,34,141,1,1,2,1,3,1,4,"Low",0,0
"227",2,27,1,1.4657,100,101,3,2,1,0,1,1,4,"Low",1,1
"228",2,28,1,0.9387,140,35,1,1,2,0,2,2,4,"Low",0,0
"229",2,29,0,1.4112,35,84,1,1,1,0,1,0,4,"Low",0,0
"230",2,30,0,1.4283,25,146,4,2,0,3,3,3,4,"Low",2,2
"231",2,31,0,1.1597,138,33,1,6,3,0,3,0,4,"Low",-5,5
"232",2,32,1,2.4422,17,114,2,1,3,1,4,3,4,"Low",1,1
"233",2,33,0,1.2832,114,88,1,3,2,0,2,0,4,"Low",-2,2
"234",2,34,0,1.1839,97,102,3,3,2,1,3,1,4,"Low",0,0
"235",2,35,0,1.8631,57,50,3,2,0,4,4,4,4,"Low",1,1
"236",2,36,1,1.0879,121,14,2,3,1,0,1,1,4,"Low",-1,1
"237",2,37,1,1.8092,54,52,3,1,1,0,1,1,4,"Low",2,2
"238",2,38,0,1.2028,29,33,1,6,0,1,1,1,4,"Low",-5,5
"239",2,39,1,1.2524,102,103,3,3,2,0,2,2,4,"Low",0,0
"240",2,40,0,1.5828,103,140,3,1,1,3,4,3,4,"Low",2,2
"241",2,41,0,1.3676,21,58,2,1,1,0,1,0,4,"Low",1,1
"242",2,42,0,1.9582,41,27,3,8,2,0,2,0,4,"Low",-5,5
"243",2,43,1,1.2006,14,52,3,1,1,1,2,1,4,"Low",2,2
"244",2,44,0,1.2195,90,88,1,3,1,1,2,1,4,"Low",-2,2
"245",2,45,1,1.1219,34,25,1,4,3,1,4,3,4,"Low",-3,3
"246",2,46,0,0.78809,17,88,2,3,4,2,6,2,4,"High",-1,1
"247",2,47,0,1.7123,21,121,2,2,2,2,4,2,4,"Low",0,0
"248",2,48,0,0.87234,88,27,3,8,3,1,4,1,4,"Low",-5,5
"249",2,49,0,2.4029,35,21,1,2,2,3,5,3,4,"High",-1,1
"250",2,50,0,1.3464,138,25,1,4,4,2,6,2,4,"High",-3,3
"251",2,51,0,1.0672,146,100,2,3,4,2,6,2,4,"High",-1,1
"252",2,52,0,1.7339,90,31,1,2,2,1,3,1,4,"Low",-1,1
"253",2,53,0,1.5326,104,116,7,10,1,1,2,1,4,"Low",-3,3
"254",2,54,1,0.8071,112,29,1,1,2,1,3,2,4,"Low",0,0
"255",2,55,0,0.6841,58,41,1,3,1,3,4,3,4,"Low",-2,2
"256",2,56,1,1.3879,85,123,4,2,2,0,2,2,4,"Low",2,2
"257",2,57,1,0.60753,85,66,4,1,3,0,3,3,4,"Low",3,3
"258",2,58,1,1.1515,83,141,4,1,0,2,2,0,4,"Low",3,3
"259",2,59,1,1.2546,102,140,3,1,3,4,7,3,4,"High",2,2
"260",2,60,0,0.75271,101,85,2,4,1,4,5,4,4,"High",-2,2
"261",2,61,1,1.1227,88,25,3,4,4,3,7,4,4,"High",-1,1
"262",2,62,0,1.3919,32,116,8,10,0,2,2,2,4,"Low",-2,2
"263",2,63,0,0.81244,90,114,1,1,3,3,6,3,4,"High",0,0
"264",2,64,1,0.70575,27,139,8,3,2,1,3,2,4,"Low",5,5
"265",2,65,1,1.7924,29,52,1,1,2,2,4,2,4,"Low",0,0
"266",2,66,1,3.933,66,127,1,1,1,2,3,1,4,"Low",0,0
"267",2,67,1,0.83078,141,98,1,1,3,1,4,3,4,"Low",0,0
"268",2,68,0,1.5733,33,18,6,8,2,0,2,0,4,"Low",-2,2
"269",2,69,0,1.145,97,141,3,1,3,4,7,4,4,"High",2,2
"270",2,70,1,0.85057,84,101,1,2,1,2,3,1,4,"Low",-1,1
"271",2,71,0,1.1615,29,100,1,3,3,3,6,3,4,"High",-2,2
"272",2,72,1,1.0363,102,101,3,2,4,3,7,4,4,"High",1,1
"273",2,73,0,1.9927,143,123,1,2,1,1,2,1,4,"Low",-1,1
"274",2,74,1,1.1081,123,21,2,2,2,4,6,2,4,"High",0,0
"275",2,75,0,0.93797,127,121,1,2,3,3,6,3,4,"High",-1,1
"276",2,76,1,0.91421,104,97,7,3,2,4,6,2,4,"High",4,4
"277",2,77,1,1.1874,39,143,1,1,3,2,5,3,4,"High",0,0
"278",2,78,0,0.75018,52,123,1,2,3,3,6,3,4,"High",-1,1
"279",2,79,1,1.4115,112,103,1,3,3,2,5,3,4,"High",-2,2
"280",2,80,1,1.225,31,122,2,1,2,0,2,2,4,"Low",1,1
"281",2,81,0,0.99622,90,35,1,1,4,3,7,3,4,"High",0,0
"282",2,82,1,4.3045,83,105,4,6,1,0,1,1,4,"Low",-2,2
"283",2,83,1,3.6532,32,87,8,10,1,1,2,1,4,"Low",-2,2
"284",2,84,0,0.7485,94,35,1,1,0,4,4,4,4,"Low",0,0
"285",2,85,0,1.4672,103,65,3,2,3,1,4,1,4,"Low",1,1
"286",2,86,1,1.0622,84,73,1,1,2,2,4,2,4,"Low",0,0
"287",2,87,1,1.4365,123,54,2,3,4,2,6,4,4,"High",-1,1
"288",2,88,1,2.1006,139,25,3,4,2,4,6,2,4,"High",-1,1
"289",2,89,1,0.90336,41,58,3,1,4,2,6,4,4,"High",2,2
"290",2,90,0,0.6866,39,73,1,1,4,3,7,3,4,"High",0,0
"291",2,91,0,0.83358,57,121,3,2,1,4,5,4,4,"High",1,1
"292",2,92,0,0.96,143,84,1,1,3,3,6,3,4,"High",0,0
"293",2,93,1,1.1129,54,9,3,2,3,0,3,3,4,"Low",1,1
"294",2,94,0,1.3124,58,14,1,3,3,2,5,2,4,"High",-2,2
"295",2,95,0,1.6989,127,31,1,2,4,3,7,3,4,"High",-1,1
"296",2,96,1,1.2432,143,57,1,3,4,2,6,4,4,"High",-2,2
"297",2,97,0,1.5542,105,134,6,8,1,0,1,0,4,"Low",-2,2
"298",2,98,0,1.2911,73,55,1,2,4,0,4,0,4,"Low",-1,1
"299",2,99,0,0.86304,114,100,1,3,4,4,8,4,4,"High",-2,2
"300",2,100,1,1.1065,105,34,6,1,2,4,6,2,4,"High",5,5
"301",2,101,0,1.6573,103,66,3,1,4,2,6,2,4,"High",2,2
"302",2,102,0,1.5546,122,101,1,2,1,4,5,4,4,"High",-1,1
"303",2,103,1,0.85852,84,57,1,3,4,3,7,4,4,"High",-2,2
"304",2,104,0,0.72734,31,112,2,1,4,4,8,4,4,"High",1,1
"305",2,105,0,1.0659,65,14,2,3,2,3,5,3,4,"High",-1,1
"306",2,106,0,1.0219,14,134,3,8,4,1,5,1,4,"High",-5,5
"307",2,107,0,2.4062,91,9,1,2,1,1,2,1,4,"Low",-1,1
"308",2,108,1,1.6756,32,27,8,8,2,3,5,2,4,"High",0,0
"309",2,109,1,1.4154,27,57,8,3,4,4,8,4,4,"High",5,5
"310",2,110,1,1.4209,87,105,10,6,2,3,5,2,4,"High",4,4
"311",2,111,1,0.87664,55,104,2,7,1,3,4,1,4,"Low",-5,5
"312",2,112,1,0.93942,9,29,2,1,2,4,6,2,4,"High",1,1
"313",2,113,1,1.7384,118,33,10,6,0,3,3,0,4,"Low",4,4
"314",2,114,1,0.71724,83,94,4,1,2,1,3,2,4,"Low",3,3
"315",2,115,0,1.6043,119,116,9,10,1,3,4,3,4,"Low",-1,1
"316",2,116,0,1.0812,94,98,1,1,2,2,4,2,4,"Low",0,0
"317",2,117,1,1.4818,119,105,9,6,2,4,6,2,4,"High",3,3
"318",2,118,1,1.3864,87,63,10,8,3,0,3,3,4,"Low",2,2
"319",2,119,0,2.1133,83,63,4,8,3,1,4,1,4,"Low",-4,4
"320",2,120,1,1.7765,55,94,2,1,2,3,5,2,4,"High",1,1
"321",2,121,0,0.68411,91,33,1,6,2,4,6,4,4,"High",-5,5
"322",2,122,1,1.3794,119,18,9,8,3,1,4,3,4,"Low",1,1
"323",2,123,1,1.0742,98,122,1,1,3,2,5,3,4,"High",0,0
"324",2,124,1,1.2689,104,117,7,9,4,0,4,4,4,"Low",-2,2
"325",2,125,0,0.97187,65,98,2,1,3,4,7,4,4,"High",1,1
"326",2,126,0,1.5009,83,134,4,8,4,2,6,2,4,"High",-4,4
"327",2,127,1,1.0262,58,94,1,1,4,4,8,4,4,"High",0,0
"328",2,128,1,0.89516,63,54,8,3,2,4,6,2,4,"High",5,5
"329",2,129,1,1.8197,32,18,8,8,3,2,5,3,4,"High",0,0
"330",2,130,1,0.7797,63,139,8,3,3,3,6,3,4,"High",5,5
"331",2,131,1,1.0468,139,9,3,2,4,3,7,4,4,"High",1,1
"332",2,132,1,0.86702,52,91,1,1,4,3,7,4,4,"High",0,0
"333",2,133,0,1.1181,117,87,9,10,1,4,5,4,4,"High",-1,1
"334",2,134,1,1.5839,134,63,8,8,3,4,7,3,4,"High",0,0
"335",2,135,0,1.0233,122,65,1,2,3,4,7,4,4,"High",-1,1
"336",2,136,0,2.836,119,32,9,8,4,4,8,4,4,"High",1,1
"337",2,137,1,1.14,118,18,10,8,1,3,4,1,4,"Low",2,2
"338",2,138,1,0.85968,55,91,2,1,3,4,7,3,4,"High",1,1
"339",2,139,0,0.80752,9,55,2,2,4,4,8,4,4,"High",0,0
"340",2,140,1,0.89554,134,118,8,10,4,2,6,4,4,"High",-2,2
"341",2,141,1,1.0184,18,117,8,9,4,2,6,4,4,"High",-1,1
"342",2,142,1,1.0517,66,122,1,1,3,4,7,3,4,"High",0,0
"343",2,143,1,1.0763,116,117,10,9,4,3,7,4,4,"High",1,1
"344",2,144,1,0.99721,118,117,10,9,3,4,7,3,4,"High",1,1
"345",3,1,0,0.80682,146,4,5,10,0,0,0,0,4,"Low",-5,5
"346",3,2,0,0.84458,60,18,7,10,0,0,0,0,4,"Low",-3,3
"347",3,3,1,0.56605,101,2,9,4,0,0,0,0,4,"Low",5,5
"348",3,4,0,1.2933,55,138,4,3,0,0,0,0,4,"Low",1,1
"349",3,5,1,0.80813,32,86,5,6,0,0,0,0,4,"Low",-1,1
"350",3,6,1,1.1741,139,55,4,4,0,1,1,0,4,"Low",0,0
"351",3,7,0,0.60738,120,124,10,10,0,0,0,0,4,"Low",0,0
"352",3,8,0,0.88086,133,41,4,8,0,0,0,0,4,"Low",-4,4
"353",3,9,0,0.97963,68,78,9,8,0,0,0,0,4,"Low",1,1
"354",3,10,1,0.61823,119,100,10,6,0,0,0,0,4,"Low",4,4
"355",3,11,1,0.92785,4,143,10,5,1,0,1,1,4,"Low",5,5
"356",3,12,1,0.66518,45,118,10,9,0,0,0,0,4,"Low",1,1
"357",3,13,0,0.54035,139,70,4,8,1,0,1,0,4,"Low",-4,4
"358",3,14,0,0.89365,82,46,8,10,0,0,0,0,4,"Low",-2,2
"359",3,15,1,0.82041,86,51,6,1,1,0,1,1,4,"Low",5,5
"360",3,16,0,0.92307,60,2,7,4,1,1,2,1,4,"Low",3,3
"361",3,17,1,0.93237,146,118,5,9,1,1,2,1,4,"Low",-4,4
"362",3,18,1,0.95704,46,60,10,7,1,2,3,1,4,"Low",3,3
"363",3,19,0,0.69321,2,101,4,9,2,1,3,1,4,"Low",-5,5
"364",3,20,1,0.85264,101,11,9,8,2,0,2,2,4,"Low",1,1
"365",3,21,1,1.0398,26,55,5,4,0,2,2,0,4,"Low",1,1
"366",3,22,0,0.69938,51,112,1,5,1,0,1,0,4,"Low",-4,4
"367",3,23,0,0.7587,21,34,8,10,0,0,0,0,4,"Low",-2,2
"368",3,24,1,1.0613,35,21,10,8,0,1,1,0,4,"Low",2,2
"369",3,25,0,0.67534,132,8,7,5,0,0,0,0,4,"Low",2,2
"370",3,26,0,0.94123,85,143,4,5,0,1,1,1,4,"Low",-1,1
"371",3,27,1,0.74855,120,60,10,7,1,3,4,1,4,"Low",3,3
"372",3,28,0,0.75736,10,111,3,2,0,0,0,0,4,"Low",1,1
"373",3,29,0,1.1342,118,20,9,10,2,0,2,0,4,"Low",-1,1
"374",3,30,1,1.989,26,120,5,10,1,2,3,1,4,"Low",-5,5
"375",3,31,1,1.4529,21,143,8,5,2,2,4,2,4,"Low",3,3
"376",3,32,0,1.2222,27,70,4,8,0,1,1,1,4,"Low",-4,4
"377",3,33,0,0.79291,60,139,7,4,4,2,6,2,4,"High",3,3
"378",3,34,1,1.8403,41,65,8,10,1,0,1,1,4,"Low",-2,2
"379",3,35,0,1.0858,2,25,4,7,3,0,3,0,4,"Low",-3,3
"380",3,36,1,1.0964,138,146,3,5,1,2,3,1,4,"Low",-2,2
"381",3,37,0,1.6165,139,41,4,8,3,2,5,2,4,"High",-4,4
"382",3,38,1,3.143,18,86,10,6,1,2,3,1,4,"Low",4,4
"383",3,39,0,1.1203,146,122,5,10,3,0,3,0,4,"Low",-5,5
"384",3,40,0,3.0497,62,143,4,5,0,3,3,3,4,"Low",-1,1
"385",3,41,0,1.2712,4,89,10,10,2,0,2,0,4,"Low",0,0
"386",3,42,0,1.5461,29,35,10,10,0,1,1,1,4,"Low",0,0
"387",3,43,1,1.4348,43,71,1,4,0,0,0,0,4,"Low",-3,3
"388",3,44,0,1.1947,27,31,4,8,1,0,1,0,4,"Low",-4,4
"389",3,45,0,0.9852,146,63,5,10,4,0,4,0,4,"Low",-5,5
"390",3,46,1,2.0414,43,94,1,3,1,0,1,1,4,"Low",-2,2
"391",3,47,0,1.0876,85,11,4,8,1,1,2,1,4,"Low",-4,4
"392",3,48,0,1.3228,4,35,10,10,3,2,5,2,4,"High",0,0
"393",3,49,0,1.3402,2,8,4,5,4,1,5,1,4,"High",-1,1
"394",3,50,0,0.90626,8,31,5,8,2,1,3,1,4,"Low",-3,3
"395",3,51,1,1.0516,122,66,10,9,1,0,1,1,4,"Low",1,1
"396",3,52,0,0.99174,30,82,3,8,0,1,1,1,4,"Low",-5,5
"397",3,53,0,1.0305,29,65,10,10,1,1,2,1,4,"Low",0,0
"398",3,54,1,0.8592,112,4,5,10,1,4,5,1,4,"High",-5,5
"399",3,55,1,0.97505,26,85,5,4,2,2,4,2,4,"Low",1,1
"400",3,56,1,0.98259,113,132,10,7,0,1,1,0,4,"Low",3,3
"401",3,57,0,0.73836,101,124,9,10,3,1,4,1,4,"Low",-1,1
"402",3,58,1,0.87943,114,120,10,10,0,3,3,0,4,"Low",0,0
"403",3,59,0,0.98823,139,31,4,8,4,2,6,2,4,"High",-4,4
"404",3,60,1,1.0967,21,143,8,5,3,4,7,3,4,"High",3,3
"405",3,61,1,0.99343,31,100,8,6,3,1,4,3,4,"Low",2,2
"406",3,62,1,0.85609,112,119,5,10,2,1,3,2,4,"Low",-5,5
"407",3,63,1,1.0028,112,62,5,4,3,1,4,3,4,"Low",1,1
"408",3,64,0,0.65661,26,124,5,10,3,2,5,2,4,"High",-5,5
"409",3,65,0,1.0694,68,124,9,10,1,3,4,3,4,"Low",-1,1
"410",3,66,0,0.87417,82,124,8,10,2,4,6,4,4,"High",-2,2
"411",3,67,0,0.80551,132,89,7,10,2,1,3,1,4,"Low",-3,3
"412",3,68,1,1.1643,112,21,5,8,4,4,8,4,4,"High",-3,3
"413",3,69,1,1.4676,43,27,1,4,2,2,4,2,4,"Low",-3,3
"414",3,70,0,1.1121,41,122,8,10,3,2,5,2,4,"High",-2,2
"415",3,71,0,1.6888,25,41,7,8,1,4,5,4,4,"High",-1,1
"416",3,72,1,1.2517,114,119,10,10,1,2,3,1,4,"Low",0,0
"417",3,73,0,0.85235,8,86,5,6,3,3,6,3,4,"High",-1,1
"418",3,74,1,2.1098,119,11,10,8,3,2,5,3,4,"High",2,2
"419",3,75,1,1.4205,65,101,10,9,2,4,6,2,4,"High",1,1
"420",3,76,0,1.8018,133,100,4,6,1,2,3,2,4,"Low",-2,2
"421",3,77,1,1.1038,111,115,2,7,1,0,1,1,4,"Low",-5,5
"422",3,78,0,0.85013,10,11,3,8,1,3,4,3,4,"Low",-5,5
"423",3,79,0,2.1992,55,94,4,3,3,1,4,1,4,"Low",1,1
"424",3,80,1,1.22,45,66,10,9,1,1,2,1,4,"Low",1,1
"425",3,81,0,1.114,86,65,6,10,4,3,7,3,4,"High",-4,4
"426",3,82,1,1.8342,71,11,4,8,1,4,5,1,4,"High",-4,4
"427",3,83,1,1.4669,34,65,10,10,1,4,5,1,4,"High",0,0
"428",3,84,1,1.1556,114,26,10,5,2,4,6,2,4,"High",5,5
"429",3,85,0,1.6934,113,76,10,10,1,0,1,0,4,"Low",0,0
"430",3,86,1,0.88076,35,120,10,10,3,4,7,3,4,"High",0,0
"431",3,87,0,1.4357,31,20,8,10,4,1,5,1,4,"High",-2,2
"432",3,88,0,2.2455,32,63,5,10,1,1,2,1,4,"Low",-5,5
"433",3,89,0,0.92883,32,25,5,7,2,2,4,2,4,"Low",-2,2
"434",3,90,0,1.2753,10,51,3,1,2,2,4,2,4,"Low",2,2
"435",3,91,1,0.78357,71,140,4,2,2,0,2,2,4,"Low",2,2
"436",3,92,1,0.97683,114,118,10,9,3,3,6,3,4,"High",1,1
"437",3,93,1,1.1284,78,32,8,5,1,3,4,1,4,"Low",3,3
"438",3,94,0,1.5936,115,113,7,10,1,2,3,2,4,"Low",-3,3
"439",3,95,0,1.0723,66,46,9,10,2,2,4,2,4,"Low",-1,1
"440",3,96,0,0.7967,82,46,8,10,3,3,6,3,4,"High",-2,2
"441",3,97,0,1.7543,71,78,4,8,3,2,5,2,4,"High",-4,4
"442",3,98,1,1.2274,20,70,10,8,2,2,4,2,4,"Low",2,2
"443",3,99,0,1.5046,94,32,3,5,2,4,6,4,4,"High",-2,2
"444",3,100,1,1.0106,46,63,10,10,4,2,6,4,4,"High",0,0
"445",3,101,0,1.1615,132,114,7,10,3,4,7,4,4,"High",-3,3
"446",3,102,1,1.5654,94,50,3,2,3,0,3,3,4,"Low",1,1
"447",3,103,1,1.456,25,63,7,10,3,3,6,3,4,"High",-3,3
"448",3,104,1,0.92498,122,132,10,7,3,4,7,3,4,"High",3,3
"449",3,105,0,0.83892,66,34,9,10,3,2,5,2,4,"High",-1,1
"450",3,106,0,0.89037,82,76,8,10,4,1,5,1,4,"High",-2,2
"451",3,107,1,1.1088,111,85,2,4,2,3,5,2,4,"High",-2,2
"452",3,108,0,0.96435,30,71,3,4,1,4,5,4,4,"High",-1,1
"453",3,109,0,1.6279,111,25,2,7,3,4,7,4,4,"High",-5,5
"454",3,110,1,0.8896,138,85,3,4,2,4,6,2,4,"High",-1,1
"455",3,111,1,1.1412,68,29,9,10,2,2,4,2,4,"Low",-1,1
"456",3,112,0,1.8591,27,100,4,6,3,3,6,3,4,"High",-2,2
"457",3,113,1,1.1755,94,30,3,3,4,2,6,4,4,"High",0,0
"458",3,114,1,0.90333,78,133,8,4,3,2,5,3,4,"High",4,4
"459",3,115,0,0.94187,18,122,10,10,2,4,6,4,4,"High",0,0
"460",3,116,1,0.74732,113,100,10,6,3,4,7,3,4,"High",4,4
"461",3,117,0,0.77952,63,34,10,10,4,3,7,3,4,"High",0,0
"462",3,118,1,1.1418,133,10,4,3,3,3,6,3,4,"High",1,1
"463",3,119,1,0.62602,76,8,10,5,2,4,6,2,4,"High",5,5
"464",3,120,0,0.6974,115,18,7,10,2,3,5,3,4,"High",-3,3
"465",3,121,1,0.88106,68,118,9,9,3,4,7,3,4,"High",0,0
"466",3,122,1,0.95554,27,55,4,4,4,4,8,4,4,"High",0,0
"467",3,123,1,0.86305,89,70,10,8,2,3,5,2,4,"High",2,2
"468",3,124,1,0.71746,51,30,1,3,3,3,6,3,4,"High",-2,2
"469",3,125,1,0.66953,89,20,10,10,3,3,6,3,4,"High",0,0
"470",3,126,0,0.72832,20,45,10,10,4,2,6,2,4,"High",0,0
"471",3,127,0,1.1054,70,45,8,10,4,3,7,3,4,"High",-2,2
"472",3,128,0,0.69152,115,138,7,3,3,3,6,3,4,"High",4,4
"473",3,129,1,1.0388,68,119,9,10,4,4,8,4,4,"High",-1,1
"474",3,130,0,0.60354,113,35,10,10,4,4,8,4,4,"High",0,0
"475",3,131,1,0.68995,140,115,2,7,1,4,5,1,4,"High",-5,5
"476",3,132,1,0.74155,133,111,4,2,4,4,8,4,4,"High",2,2
"477",3,133,1,0.68725,50,10,2,3,1,4,5,1,4,"High",-1,1
"478",3,134,0,1.0099,62,43,4,1,2,3,5,3,4,"High",3,3
"479",3,135,0,0.63186,89,76,10,10,4,3,7,3,4,"High",0,0
"480",3,136,1,0.86067,50,140,2,2,2,2,4,2,4,"Low",0,0
"481",3,137,0,0.59863,18,76,10,10,4,4,8,4,4,"High",0,0
"482",3,138,1,1.1487,45,78,10,8,4,4,8,4,4,"High",2,2
"483",3,139,0,0.77278,62,66,4,9,3,4,7,4,4,"High",-5,5
"484",3,140,1,0.85188,50,128,2,1,3,0,3,3,4,"Low",1,1
"485",3,141,0,0.8069,140,43,2,1,3,4,7,4,4,"High",1,1
"486",3,142,0,0.91628,30,51,3,1,4,4,8,4,4,"High",2,2
"487",3,143,0,1.7573,50,62,2,4,4,4,8,4,4,"High",-2,2
"488",3,144,1,0.6984,140,128,2,1,4,1,5,4,4,"High",1,1
"489",3,145,1,0.66208,138,128,3,1,4,2,6,4,4,"High",2,2
"490",3,146,0,0.74611,29,34,10,10,3,4,7,4,4,"High",0,0
"491",4,1,1,1.2054,147,145,4,6,0,0,0,0,4,"Low",-2,2
"492",4,2,0,0.65344,147,33,4,5,1,0,1,0,4,"Low",-1,1
"493",4,3,1,0.98672,99,45,4,5,0,0,0,0,4,"Low",-1,1
"494",4,4,1,1.0036,20,103,4,2,0,0,0,0,4,"Low",2,2
"495",4,5,0,0.65172,63,100,5,3,0,0,0,0,4,"Low",2,2
"496",4,6,1,0.97963,92,141,1,1,0,0,0,0,4,"Low",0,0
"497",4,7,1,1.0915,74,139,2,3,0,0,0,0,4,"Low",-1,1
"498",4,8,1,0.67109,18,104,6,4,0,0,0,0,4,"Low",2,2
"499",4,9,0,0.75363,14,99,3,4,0,1,1,1,4,"Low",-1,1
"500",4,10,0,0.83902,145,89,6,1,1,0,1,0,4,"Low",5,5
"501",4,11,1,1.0392,140,66,4,2,0,0,0,0,4,"Low",2,2
"502",4,12,1,1.471,92,89,1,1,1,1,2,1,4,"Low",0,0
"503",4,13,1,0.58649,119,110,7,4,0,0,0,0,4,"Low",3,3
"504",4,14,1,0.70441,65,82,4,2,0,0,0,0,4,"Low",2,2
"505",4,15,0,1.6506,77,65,2,4,0,1,1,1,4,"Low",-2,2
"506",4,16,1,0.88936,134,110,1,4,0,1,1,0,4,"Low",-3,3
"507",4,17,0,0.83138,141,100,1,3,1,1,2,1,4,"Low",-2,2
"508",4,18,0,1.2786,141,89,1,1,2,2,4,2,4,"Low",0,0
"509",4,19,1,0.81796,18,116,6,4,1,0,1,1,4,"Low",2,2
"510",4,20,0,0.97052,139,20,3,4,1,1,2,1,4,"Low",-1,1
"511",4,21,1,0.61664,104,117,4,5,1,0,1,1,4,"Low",-1,1
"512",4,22,0,0.71149,87,119,2,7,0,1,1,1,4,"Low",-5,5
"513",4,23,0,0.65017,82,50,2,1,1,0,1,0,4,"Low",1,1
"514",4,24,0,1.135,26,41,3,5,0,0,0,0,4,"Low",-2,2
"515",4,25,0,0.74084,147,104,4,4,2,2,4,2,4,"Low",0,0
"516",4,26,1,1.5949,99,102,4,1,2,0,2,2,4,"Low",3,3
"517",4,27,0,0.76366,104,116,4,4,3,1,4,1,4,"Low",0,0
"518",4,28,1,1.0658,117,87,5,2,1,1,2,1,4,"Low",3,3
"519",4,29,1,1.3708,125,21,2,3,0,0,0,0,4,"Low",-1,1
"520",4,30,1,0.83374,63,118,5,8,1,0,1,1,4,"Low",-3,3
"521",4,31,1,0.53853,100,26,3,3,2,1,3,2,4,"Low",0,0
"522",4,32,1,0.7046,140,26,4,3,1,2,3,1,4,"Low",1,1
"523",4,33,1,0.98189,20,147,4,4,2,3,5,2,4,"High",0,0
"524",4,34,0,1.562,145,89,6,1,2,3,5,3,4,"High",5,5
"525",4,35,1,0.61539,31,20,7,4,0,3,3,0,4,"Low",3,3
"526",4,36,1,0.57279,103,8,2,1,1,0,1,1,4,"Low",1,1
"527",4,37,0,0.63417,87,102,2,1,2,1,3,1,4,"Low",1,1
"528",4,38,1,0.51339,87,21,2,3,3,1,4,3,4,"Low",-1,1
"529",4,39,0,0.97014,145,139,6,3,3,2,5,2,4,"High",3,3
"530",4,40,1,0.74606,116,2,4,1,2,0,2,2,4,"Low",3,3
"531",4,41,1,0.63905,113,53,8,4,0,0,0,0,4,"Low",4,4
"532",4,42,0,1.0129,26,104,3,4,3,4,7,4,4,"High",-1,1
"533",4,43,0,0.90472,46,66,4,2,0,1,1,1,4,"Low",2,2
"534",4,44,1,0.72565,117,102,5,1,2,2,4,2,4,"Low",4,4
"535",4,45,0,1.0756,41,33,5,5,1,1,2,1,4,"Low",0,0
"536",4,46,1,0.7951,20,17,4,8,4,0,4,4,4,"Low",-4,4
"537",4,47,1,5.4298,99,65,4,4,3,2,5,3,4,"High",0,0
"538",4,48,1,1.0751,63,53,5,4,2,1,3,2,4,"Low",1,1
"539",4,49,0,2.5704,92,117,1,5,2,3,5,3,4,"High",-4,4
"540",4,50,0,0.7414,45,82,5,2,1,2,3,2,4,"Low",3,3
"541",4,51,1,0.74216,100,50,3,1,3,1,4,3,4,"Low",2,2
"542",4,52,0,0.59143,8,33,1,5,1,2,3,2,4,"Low",-4,4
"543",4,53,1,0.61768,134,100,1,3,1,4,5,1,4,"High",-2,2
"544",4,54,1,0.72429,8,21,1,3,2,2,4,2,4,"Low",-2,2
"545",4,55,1,0.54488,95,87,2,2,0,4,4,0,4,"Low",0,0
"546",4,56,0,1.0642,66,31,2,7,2,1,3,1,4,"Low",-5,5
"547",4,57,1,1.3392,139,45,3,5,3,2,5,3,4,"High",-2,2
"548",4,58,1,1.2939,99,74,4,2,4,1,5,4,4,"High",2,2
"549",4,59,1,0.4833,41,33,5,5,2,3,5,2,4,"High",0,0
"550",4,60,1,1.663,8,53,1,4,3,2,5,3,4,"High",-3,3
"551",4,61,1,2.3831,125,27,2,4,1,0,1,1,4,"Low",-2,2
"552",4,62,1,1.2698,50,114,1,2,2,0,2,2,4,"Low",-1,1
"553",4,63,1,1.7881,103,28,2,2,2,0,2,2,4,"Low",0,0
"554",4,64,0,0.94392,95,92,2,1,1,3,4,3,4,"Low",1,1
"555",4,65,1,0.81617,119,93,7,5,2,0,2,2,4,"Low",2,2
"556",4,66,1,0.57895,93,8,5,1,1,4,5,1,4,"High",4,4
"557",4,67,0,0.77557,119,33,7,5,3,4,7,4,4,"High",2,2
"558",4,68,1,0.65022,103,74,2,2,3,2,5,3,4,"High",0,0
"559",4,69,1,0.59345,114,102,2,1,1,3,4,1,4,"Low",1,1
"560",4,70,0,0.84504,28,114,2,2,1,2,3,2,4,"Low",0,0
"561",4,71,1,1.2275,132,65,2,4,0,3,3,0,4,"Low",-2,2
"562",4,72,1,0.90511,21,82,3,2,3,3,6,3,4,"High",1,1
"563",4,73,1,1.3072,125,2,2,1,2,1,3,2,4,"Low",1,1
"564",4,74,1,0.71444,95,77,2,2,2,1,3,2,4,"Low",0,0
"565",4,75,1,0.68502,114,116,2,4,3,3,6,3,4,"High",-2,2
"566",4,76,1,0.46921,45,27,5,4,3,1,4,3,4,"Low",1,1
"567",4,77,0,0.81196,95,131,2,1,3,0,3,0,4,"Low",1,1
"568",4,78,1,0.79849,50,28,1,2,3,2,5,3,4,"High",-1,1
"569",4,79,1,1.1206,93,102,5,1,2,4,6,2,4,"High",4,4
"570",4,80,0,1.3186,14,117,3,5,1,4,5,4,4,"High",-2,2
"571",4,81,0,0.75195,77,26,2,3,2,4,6,4,4,"High",-1,1
"572",4,82,0,1.2849,131,53,1,4,1,3,4,3,4,"Low",-3,3
"573",4,83,1,3.1082,17,53,8,4,1,4,5,1,4,"High",4,4
"574",4,84,0,0.86213,41,67,5,7,3,0,3,0,4,"Low",-2,2
"575",4,85,0,1.8496,89,66,1,2,4,3,7,3,4,"High",-1,1
"576",4,86,1,0.57233,67,27,7,4,1,2,3,1,4,"Low",3,3
"577",4,87,1,0.47165,63,65,5,4,3,4,7,3,4,"High",1,1
"578",4,88,1,0.59515,141,122,1,6,3,0,3,3,4,"Low",-5,5
"579",4,89,0,0.94507,147,132,4,2,4,1,5,1,4,"High",2,2
"580",4,90,1,0.58507,122,95,6,2,1,4,5,1,4,"High",4,4
"581",4,91,0,0.93124,77,134,2,1,3,2,5,2,4,"High",1,1
"582",4,92,1,0.72384,67,122,7,6,2,2,4,2,4,"Low",1,1
"583",4,93,1,0.50076,140,28,4,2,2,3,5,2,4,"High",2,2
"584",4,94,0,0.7093,140,122,4,6,3,3,6,3,4,"High",-2,2
"585",4,95,0,0.91755,139,113,3,8,4,1,5,1,4,"High",-5,5
"586",4,96,1,0.89321,122,63,6,5,4,4,8,4,4,"High",1,1
"587",4,97,0,0.8613,18,114,6,2,2,4,6,4,4,"High",4,4
"588",4,98,0,0.87267,45,67,5,7,4,3,7,3,4,"High",-2,2
"589",4,99,0,0.87746,130,27,1,4,0,3,3,3,4,"Low",-3,3
"590",4,100,0,0.7674,46,41,4,5,1,4,5,4,4,"High",-1,1
"591",4,101,1,1.2366,103,110,2,4,4,2,6,4,4,"High",-2,2
"592",4,102,1,0.95932,50,125,1,2,4,3,7,4,4,"High",-1,1
"593",4,103,1,1.2671,66,21,2,3,4,4,8,4,4,"High",-1,1
"594",4,104,0,0.64652,110,2,4,1,3,2,5,2,4,"High",3,3
"595",4,105,1,0.48381,116,119,4,7,4,4,8,4,4,"High",-3,3
"596",4,106,1,4.0827,14,145,3,6,2,4,6,2,4,"High",-3,3
"597",4,107,1,0.5414,31,118,7,8,2,1,3,2,4,"Low",-1,1
"598",4,108,1,0.702,2,14,1,3,3,3,6,3,4,"High",-2,2
"599",4,109,1,0.54603,18,113,6,8,3,2,5,3,4,"High",-2,2
"600",4,110,0,0.71008,74,31,2,7,3,3,6,3,4,"High",-5,5
"601",4,111,0,3.4611,27,31,4,7,4,4,8,4,4,"High",-3,3
"602",4,112,0,0.63621,82,67,2,7,4,4,8,4,4,"High",-5,5
"603",4,113,0,0.64887,110,18,4,6,4,4,8,4,4,"High",-2,2
"604",4,114,1,0.8016,46,28,4,2,2,4,6,2,4,"High",2,2
"605",4,115,1,0.51912,140,146,4,7,4,0,4,4,4,"Low",-3,3
"606",4,116,1,0.58991,113,93,8,5,3,3,6,3,4,"High",3,3
"607",4,117,1,0.4717,134,125,1,2,3,4,7,3,4,"High",-1,1
"608",4,118,1,5.3698,77,130,2,1,4,1,5,4,4,"High",1,1
"609",4,119,1,1.6246,134,131,1,1,4,2,6,4,4,"High",0,0
"610",4,120,1,0.46062,92,132,1,2,4,2,6,4,4,"High",-1,1
"611",4,121,1,0.30543,74,93,2,5,4,4,8,4,4,"High",-3,3
"612",4,122,0,0.66734,14,17,3,8,4,2,6,2,4,"High",-5,5
"613",4,123,1,2.2882,17,146,8,7,3,1,4,3,4,"Low",1,1
"614",4,124,1,0.50706,113,146,8,7,4,2,6,4,4,"High",1,1
"615",4,125,1,0.50423,46,2,4,1,3,4,7,3,4,"High",3,3
"616",4,126,1,1.2064,118,46,8,4,2,4,6,2,4,"High",4,4
"617",4,127,1,1.553,146,17,7,8,3,4,7,3,4,"High",-1,1
"618",4,128,0,0.71765,131,132,1,2,3,3,6,3,4,"High",-1,1
"619",4,129,1,0.81949,132,131,2,1,4,4,8,4,4,"High",1,1
"620",4,130,0,1.5759,118,146,8,7,3,4,7,4,4,"High",1,1
"621",4,131,1,1.1159,130,141,1,1,2,4,6,2,4,"High",0,0
"622",5,1,0,1.1617,135,73,6,8,0,0,0,0,3,"Low",-2,2
"623",5,2,1,1.3137,50,51,7,10,0,0,0,0,3,"Low",-3,3
"624",5,3,0,0.58155,59,34,6,10,0,0,0,0,3,"Low",-4,4
"625",5,4,1,0.88161,18,138,6,3,0,0,0,0,3,"Low",3,3
"626",5,5,0,1.7336,36,73,8,8,0,1,1,1,3,"Low",0,0
"627",5,6,1,4.0588,69,119,8,8,0,0,0,0,3,"Low",0,0
"628",5,7,1,2.1142,50,55,7,9,1,0,1,1,3,"Low",-2,2
"629",5,8,0,0.64653,120,66,5,10,0,0,0,0,3,"Low",-5,5
"630",5,9,1,0.85923,88,12,3,5,0,0,0,0,3,"Low",-2,2
"631",5,10,0,1.4686,137,31,9,7,0,0,0,0,3,"Low",2,2
"632",5,11,1,1.6946,12,95,5,1,1,0,1,1,3,"Low",4,4
"633",5,12,1,1.7112,34,32,10,8,1,0,1,1,3,"Low",2,2
"634",5,13,1,0.78148,123,95,4,1,0,1,1,0,3,"Low",3,3
"635",5,14,1,0.82727,32,44,8,8,1,0,1,1,3,"Low",0,0
"636",5,15,1,0.94939,63,32,6,8,0,2,2,0,3,"Low",-2,2
"637",5,16,1,1.1813,55,135,9,6,1,1,2,1,3,"Low",3,3
"638",5,17,1,0.92825,98,29,7,7,0,0,0,0,3,"Low",0,0
"639",5,18,0,0.87444,95,18,1,6,2,1,3,1,3,"Low",-5,5
"640",5,19,1,0.6297,98,120,7,5,1,1,2,1,3,"Low",2,2
"641",5,20,1,0.56782,113,10,5,5,0,0,0,0,3,"Low",0,0
"642",5,21,0,0.65174,5,133,8,8,0,0,0,0,3,"Low",0,0
"643",5,22,1,0.92718,63,59,6,6,1,1,2,1,3,"Low",0,0
"644",5,23,1,1.0005,129,147,7,4,0,0,0,0,3,"Low",3,3
"645",5,24,0,0.58007,59,133,6,8,2,1,3,1,3,"Low",-2,2
"646",5,25,0,0.80076,32,63,8,6,3,2,5,2,3,"High",2,2
"647",5,26,0,0.79661,5,139,8,6,1,0,1,0,3,"Low",2,2
"648",5,27,1,1.2207,84,135,8,6,0,2,2,0,3,"Low",2,2
"649",5,28,0,1.1101,43,69,3,8,0,1,1,1,3,"Low",-5,5
"650",5,29,1,1.5833,114,14,8,7,0,0,0,0,3,"Low",1,1
"651",5,30,0,0.76625,31,114,7,8,1,1,2,1,3,"Low",-1,1
"652",5,31,1,0.88821,114,89,8,6,2,0,2,2,3,"Low",2,2
"653",5,32,1,0.81813,138,59,3,6,1,3,4,1,3,"High",-3,3
"654",5,33,0,0.92958,31,87,7,10,2,0,2,0,3,"Low",-3,3
"655",5,34,0,0.85757,137,35,9,8,1,0,1,0,3,"Low",1,1
"656",5,35,1,1.7024,96,36,3,8,0,1,1,0,3,"Low",-5,5
"657",5,36,0,1.3392,88,101,3,7,1,0,1,0,3,"Low",-4,4
"658",5,37,1,1.6306,113,88,5,3,1,2,3,1,3,"Low",2,2
"659",5,38,1,0.98121,88,48,3,7,3,0,3,3,3,"Low",-4,4
"660",5,39,0,0.57687,52,65,4,9,0,0,0,0,3,"Low",-5,5
"661",5,40,1,2.3161,134,118,10,10,0,0,0,0,3,"Low",0,0
"662",5,41,1,0.84752,140,110,8,4,0,0,0,0,3,"Low",4,4
"663",5,42,1,1.77,116,118,6,10,0,1,1,0,3,"Low",-4,4
"664",5,43,0,0.81368,96,85,3,7,1,0,1,0,3,"Low",-4,4
"665",5,44,1,0.75574,84,105,8,10,1,0,1,1,3,"Low",-2,2
"666",5,45,1,0.7,41,1,10,5,0,0,0,0,3,"Low",5,5
"667",5,46,1,1.2243,9,59,7,6,0,4,4,0,3,"High",1,1
"668",5,47,0,0.97294,147,9,4,7,1,1,2,1,3,"Low",-3,3
"669",5,48,1,0.65911,114,79,8,7,3,0,3,3,3,"Low",1,1
"670",5,49,1,1.045,133,71,8,8,2,0,2,2,3,"Low",0,0
"671",5,50,1,1.0257,104,109,9,8,0,0,0,0,3,"Low",1,1
"672",5,51,0,1.1608,3,26,5,10,0,0,0,0,3,"Low",-5,5
"673",5,52,1,0.61467,119,123,8,4,1,1,2,1,3,"Low",4,4
"674",5,53,0,1.1308,9,32,7,8,2,4,6,4,3,"High",-1,1
"675",5,54,1,0.94006,27,105,10,10,0,1,1,0,3,"Low",0,0
"676",5,55,1,0.6923,114,103,8,8,4,0,4,4,3,"High",0,0
"677",5,56,0,0.75806,81,89,3,6,0,1,1,1,3,"Low",-3,3
"678",5,57,1,0.92294,26,143,10,8,1,0,1,1,3,"Low",2,2
"679",5,58,1,0.7651,119,126,8,3,2,0,2,2,3,"Low",5,5
"680",5,59,1,1.6026,118,144,10,8,2,0,2,2,3,"Low",2,2
"681",5,60,0,1.5258,110,71,4,8,1,1,2,1,3,"Low",-4,4
"682",5,61,0,1.1946,92,85,2,7,0,1,1,1,3,"Low",-5,5
"683",5,62,0,2.8939,52,93,4,8,1,0,1,0,3,"Low",-4,4
"684",5,63,1,0.77179,133,48,8,7,3,1,4,3,3,"High",1,1
"685",5,64,1,6.2052,43,71,3,8,1,2,3,1,3,"Low",-5,5
"686",5,65,1,0.73913,89,95,6,1,2,3,5,2,3,"High",5,5
"687",5,66,0,2.0869,46,45,4,2,0,0,0,0,3,"Low",2,2
"688",5,67,1,2.4576,133,98,8,7,4,2,6,4,3,"High",1,1
"689",5,68,1,0.98159,140,121,8,10,1,0,1,1,3,"Low",-2,2
"690",5,69,0,1.2336,52,138,4,3,2,2,4,2,3,"High",1,1
"691",5,70,1,1.5788,73,127,8,8,2,0,2,2,3,"Low",0,0
"692",5,71,1,1.8266,146,73,10,8,0,3,3,0,3,"Low",2,2
"693",5,72,1,1.3697,121,44,10,8,1,1,2,1,3,"Low",2,2
"694",5,73,0,1.2397,29,17,7,9,1,0,1,0,3,"Low",-2,2
"695",5,74,0,0.69204,5,112,8,7,2,0,2,0,3,"Low",1,1
"696",5,75,1,0.9386,16,92,3,2,0,1,1,0,3,"Low",1,1
"697",5,76,0,1.318,144,27,8,10,1,1,2,1,3,"Low",-2,2
"698",5,77,1,2.6614,89,69,6,8,3,2,5,3,3,"High",-2,2
"699",5,78,1,1.6739,138,84,3,8,3,2,5,3,3,"High",-5,5
"700",5,79,0,0.8795,88,1,3,5,4,1,5,1,3,"High",-2,2
"701",5,80,0,1.9893,105,34,10,10,2,2,4,2,3,"High",0,0
"702",5,81,1,1.9776,89,98,6,7,4,3,7,4,3,"High",-1,1
"703",5,82,0,0.92628,106,124,2,4,0,0,0,0,3,"Low",-2,2
"704",5,83,0,1.9371,35,104,8,9,1,1,2,1,3,"Low",-1,1
"705",5,84,1,0.72449,104,123,9,4,2,2,4,2,3,"High",5,5
"706",5,85,1,0.73502,87,57,10,7,1,0,1,1,3,"Low",3,3
"707",5,86,1,2.0674,14,105,7,10,1,3,4,1,3,"High",-3,3
"708",5,87,1,1.3497,44,126,8,3,2,1,3,2,3,"Low",5,5
"709",5,88,0,0.7259,3,66,5,10,1,1,2,1,3,"Low",-5,5
"710",5,89,1,2.0946,31,118,7,10,3,3,6,3,3,"High",-3,3
"711",5,90,1,0.79855,26,122,10,9,2,0,2,2,3,"Low",1,1
"712",5,91,0,1.8206,103,79,8,7,1,1,2,1,3,"Low",1,1
"713",5,92,1,1.4225,58,1,6,5,0,2,2,0,3,"Low",1,1
"714",5,93,1,1.4615,102,36,4,8,0,2,2,0,3,"Low",-4,4
"715",5,94,1,0.91952,14,44,7,8,2,3,5,2,3,"High",-1,1
"716",5,95,0,0.73144,120,18,5,6,2,2,4,2,3,"High",-1,1
"717",5,96,0,1.6496,50,57,7,7,2,1,3,1,3,"Low",0,0
"718",5,97,0,1.2734,102,54,4,6,1,0,1,0,3,"Low",-2,2
"719",5,98,0,1.6235,147,110,4,4,2,2,4,2,3,"High",0,0
"720",5,99,0,6.7209,81,127,3,8,1,1,2,1,3,"Low",-5,5
"721",5,100,0,1.7385,91,41,10,10,0,1,1,1,3,"Low",0,0
"722",5,101,1,1.5791,83,112,10,7,0,1,1,0,3,"Low",3,3
"723",5,102,1,2.0404,137,67,9,8,2,0,2,2,3,"Low",1,1
"724",5,103,0,2.0039,16,94,3,8,1,0,1,0,3,"Low",-5,5
"725",5,104,0,1.4191,81,54,3,6,2,1,3,1,3,"Low",-3,3
"726",5,105,0,0.79661,48,65,7,9,2,1,3,1,3,"Low",-2,2
"727",5,106,1,1.1146,73,3,8,5,4,2,6,4,3,"High",3,3
"728",5,107,1,0.7648,85,3,7,5,2,3,5,2,3,"High",2,2
"729",5,108,0,0.63961,12,137,5,9,2,3,5,3,3,"High",-4,4
"730",5,109,1,1.5587,45,123,2,4,1,3,4,1,3,"High",-2,2
"731",5,110,1,0.97094,26,3,10,5,3,4,7,3,3,"High",5,5
"732",5,111,1,2.0088,122,146,9,10,1,1,2,1,3,"Low",-1,1
"733",5,112,1,1.5507,74,90,5,8,0,0,0,0,3,"Low",-3,3
"734",5,113,1,1.5777,94,69,8,8,1,3,4,1,3,"High",0,0
"735",5,114,0,1.725,95,120,1,5,4,3,7,3,3,"High",-4,4
"736",5,115,0,1.2589,16,101,3,7,2,1,3,1,3,"Low",-4,4
"737",5,116,0,1.5409,143,25,8,8,1,0,1,0,3,"Low",0,0
"738",5,117,0,1.6464,85,55,7,9,3,2,5,2,3,"High",-2,2
"739",5,118,0,0.79849,118,83,10,10,4,1,5,1,3,"High",0,0
"740",5,119,0,1.494,90,138,8,3,1,4,5,4,3,"High",5,5
"741",5,120,1,1.0901,35,147,8,4,2,3,5,2,3,"High",4,4
"742",5,121,0,1.0591,123,102,4,4,4,2,6,2,3,"High",0,0
"743",5,122,0,1.1301,127,31,8,7,2,4,6,4,3,"High",1,1
"744",5,123,1,0.67461,66,146,10,10,2,2,4,2,3,"High",0,0
"745",5,124,1,1.0133,45,116,2,6,2,1,3,2,3,"Low",-4,4
"746",5,125,1,1.3687,112,139,7,6,2,1,3,2,3,"Low",1,1
"747",5,126,0,1.1265,129,140,7,8,1,2,3,2,3,"Low",-1,1
"748",5,127,0,1.1963,96,97,3,7,2,0,2,0,3,"Low",-4,4
"749",5,128,1,1.0275,94,96,8,3,2,3,5,2,3,"High",5,5
"750",5,129,0,0.58008,63,140,6,8,3,3,6,3,3,"High",-2,2
"751",5,130,1,1.0724,66,5,10,8,3,3,6,3,3,"High",2,2
"752",5,131,1,1.7936,1,137,5,9,3,4,7,3,3,"High",-4,4
"753",5,132,1,0.85498,26,135,10,6,4,3,7,4,3,"High",4,4
"754",5,133,1,1.3217,91,143,10,8,1,2,3,1,3,"Low",2,2
"755",5,134,0,2.1064,17,55,9,9,1,3,4,3,3,"High",0,0
"756",5,135,1,1.6507,67,63,8,6,1,4,5,1,3,"High",2,2
"757",5,136,1,1.2506,34,55,10,9,3,4,7,3,3,"High",1,1
"758",5,137,1,5.4607,126,5,3,8,2,4,6,2,3,"High",-5,5
"759",5,138,1,1.366,35,127,8,8,3,3,6,3,3,"High",0,0
"760",5,139,1,0.9548,125,33,6,10,0,0,0,0,3,"Low",-4,4
"761",5,140,0,1.633,10,120,5,5,1,4,5,4,3,"High",0,0
"762",5,141,0,1.2872,102,104,4,9,3,3,6,3,3,"High",-5,5
"763",5,142,1,0.57685,98,144,7,8,4,2,6,4,3,"High",-1,1
"764",5,143,0,1.0258,93,35,8,8,1,4,5,4,3,"High",0,0
"765",5,144,0,0.70623,67,65,8,9,2,2,4,2,3,"High",-1,1
"766",5,145,0,0.70972,25,58,8,6,1,1,2,1,3,"Low",2,2
"767",5,146,1,0.78443,34,50,10,7,4,3,7,4,3,"High",3,3
"768",5,147,0,0.86374,135,122,6,9,4,2,6,2,3,"High",-3,3
"769",5,148,1,1.822,144,125,8,6,3,1,4,3,3,"High",2,2
"770",5,149,0,0.67921,103,65,8,9,2,3,5,3,3,"High",-1,1
"771",5,150,0,1.1201,122,14,9,7,3,3,6,3,3,"High",2,2
"772",5,151,0,0.6681,110,44,4,8,3,4,7,4,3,"High",-4,4
"773",5,152,1,0.54161,14,79,7,7,4,2,6,4,3,"High",0,0
"774",5,153,0,1.0217,125,45,6,2,2,3,5,3,3,"High",4,4
"775",5,154,0,0.63562,91,66,10,10,2,4,6,4,3,"High",0,0
"776",5,155,1,1.2844,121,36,10,8,2,3,5,2,3,"High",2,2
"777",5,156,0,0.77935,46,25,4,8,1,2,3,2,3,"Low",-4,4
"778",5,157,1,1.1846,129,91,7,10,2,3,5,2,3,"High",-3,3
"779",5,158,1,1.1739,113,146,5,10,2,3,5,2,3,"High",-5,5
"780",5,159,1,4.4374,134,109,10,8,1,1,2,1,3,"Low",2,2
"781",5,160,1,1.5207,113,84,5,8,3,3,6,3,3,"High",-3,3
"782",5,161,1,1.3995,18,51,6,10,3,1,4,3,3,"High",-4,4
"783",5,162,1,1.1527,69,79,8,7,4,3,7,4,3,"High",1,1
"784",5,163,1,0.96945,85,144,7,8,4,4,8,4,3,"High",-1,1
"785",5,164,1,1.0702,16,119,3,8,3,3,6,3,3,"High",-5,5
"786",5,165,0,1.1108,43,70,3,7,2,0,2,0,3,"Low",-4,4
"787",5,166,1,0.89436,50,143,7,8,4,3,7,4,3,"High",-1,1
"788",5,167,1,0.87685,90,147,8,4,2,4,6,2,3,"High",4,4
"789",5,168,0,1.0015,57,100,7,10,2,0,2,0,3,"Low",-3,3
"790",5,169,1,1.1835,139,1,6,5,2,4,6,2,3,"High",1,1
"791",5,170,1,1.0564,46,112,4,7,2,3,5,2,3,"High",-3,3
"792",5,171,0,0.66843,109,143,8,8,2,4,6,4,3,"High",0,0
"793",5,172,0,2.0944,18,100,6,10,4,1,5,1,3,"High",-4,4
"794",5,173,1,1.3519,36,48,8,7,4,3,7,4,3,"High",1,1
"795",5,174,1,0.68783,87,97,10,7,2,1,3,2,3,"Low",3,3
"796",5,175,1,1.274,103,90,8,8,3,3,6,3,3,"High",0,0
"797",5,176,0,0.89989,2,33,8,10,0,1,1,1,3,"Low",-2,2
"798",5,177,1,0.88949,139,17,6,9,3,2,5,3,3,"High",-3,3
"799",5,178,0,0.64347,112,97,7,7,4,2,6,2,3,"High",0,0
"800",5,179,0,0.71304,70,99,7,10,1,0,1,0,3,"Low",-3,3
"801",5,180,0,1.1249,79,91,7,10,4,4,8,4,3,"High",-3,3
"802",5,181,0,0.86756,93,29,8,7,2,2,4,2,3,"High",1,1
"803",5,182,0,1.2143,48,96,7,3,4,4,8,4,3,"High",4,4
"804",5,183,0,0.5345,12,102,5,4,3,4,7,4,3,"High",1,1
"805",5,184,1,0.63511,41,71,10,8,2,3,5,2,3,"High",2,2
"806",5,185,0,1.3,101,104,7,9,2,4,6,4,3,"High",-2,2
"807",5,186,0,0.82337,90,97,8,7,4,3,7,3,3,"High",1,1
"808",5,187,1,0.75347,65,41,9,10,4,3,7,4,3,"High",-1,1
"809",5,188,0,2.4535,103,27,8,10,4,2,6,2,3,"High",-2,2
"810",5,189,0,1.5742,74,97,5,7,1,4,5,4,3,"High",-2,2
"811",5,190,0,1.4649,27,87,10,10,3,3,6,3,3,"High",0,0
"812",5,191,0,0.75035,105,33,10,10,4,2,6,2,3,"High",0,0
"813",5,192,1,0.99179,84,124,8,4,4,1,5,4,3,"High",4,4
"814",5,193,0,0.73172,119,67,8,8,4,3,7,3,3,"High",0,0
"815",5,194,1,0.70639,126,9,3,7,3,3,6,3,3,"High",-4,4
"816",5,195,0,0.60609,2,100,8,10,1,2,3,2,3,"Low",-2,2
"817",5,196,0,0.7417,122,99,9,10,4,1,5,1,3,"High",-1,1
"818",5,197,0,2.5853,43,125,3,6,3,3,6,3,3,"High",-3,3
"819",5,198,0,0.71059,124,93,4,8,2,3,5,3,3,"High",-4,4
"820",5,199,1,0.98854,99,27,10,10,2,4,6,2,3,"High",0,0
"821",5,200,1,0.84089,139,40,6,1,4,0,4,4,3,"High",5,5
"822",6,1,1,1.1521,127,129,3,8,0,0,0,0,4,"Low",-5,5
"823",6,2,1,2.3385,145,44,4,3,0,0,0,0,4,"Low",1,1
"824",6,3,0,1.2267,104,93,8,9,0,0,0,0,4,"Low",-1,1
"825",6,4,0,0.94468,141,70,8,10,0,0,0,0,4,"Low",-2,2
"826",6,5,0,1.0421,21,45,2,5,0,0,0,0,4,"Low",-3,3
"827",6,6,0,0.83682,4,45,3,5,0,1,1,1,4,"Low",-2,2
"828",6,7,0,1.1148,145,118,4,7,1,0,1,0,4,"Low",-3,3
"829",6,8,1,6.092,34,122,6,8,0,0,0,0,4,"Low",-2,2
"830",6,9,0,1.2069,43,31,7,2,0,0,0,0,4,"Low",5,5
"831",6,10,0,1.5462,126,87,7,6,0,0,0,0,4,"Low",1,1
"832",6,11,0,0.86902,111,46,3,5,0,0,0,0,4,"Low",-2,2
"833",6,12,0,1.6223,77,89,2,7,0,0,0,0,4,"Low",-5,5
"834",6,13,0,1.5816,40,33,7,3,0,0,0,0,4,"Low",4,4
"835",6,14,1,1.3659,89,83,7,8,1,0,1,1,4,"Low",-1,1
"836",6,15,1,1.0699,46,19,5,5,1,0,1,1,4,"Low",0,0
"837",6,16,0,1.0953,83,30,8,6,1,0,1,0,4,"Low",2,2
"838",6,17,1,0.77192,69,87,10,6,0,1,1,0,4,"Low",4,4
"839",6,18,0,1.7412,126,112,7,5,1,0,1,0,4,"Low",2,2
"840",6,19,0,1.4379,50,35,2,7,0,0,0,0,4,"Low",-5,5
"841",6,20,0,1.0141,43,31,7,2,1,1,2,1,4,"Low",5,5
"842",6,21,0,1.46,20,113,2,3,0,0,0,0,4,"Low",-1,1
"843",6,22,0,2.8326,31,114,2,1,2,0,2,0,4,"Low",1,1
"844",6,23,0,2.0555,146,122,9,8,0,1,1,1,4,"Low",1,1
"845",6,24,0,0.9555,44,112,3,5,1,1,2,1,4,"Low",-2,2
"846",6,25,0,1.2176,146,93,9,9,1,1,2,1,4,"Low",0,0
"847",6,26,0,1.0648,83,40,8,7,2,1,3,1,4,"Low",1,1
"848",6,27,1,2.1118,111,43,3,7,1,2,3,1,4,"Low",-4,4
"849",6,28,1,1.2071,137,144,10,8,0,0,0,0,4,"Low",2,2
"850",6,29,1,1.0692,137,30,10,6,1,1,2,1,4,"Low",4,4
"851",6,30,0,1.0665,1,46,2,5,0,2,2,2,4,"Low",-3,3
"852",6,31,0,1.0611,146,30,9,6,2,2,4,2,4,"Low",3,3
"853",6,32,0,1.0739,126,35,7,7,2,1,3,1,4,"Low",0,0
"854",6,33,0,2.5267,141,51,8,3,1,0,1,0,4,"Low",5,5
"855",6,34,0,1.8084,140,30,1,6,0,3,3,3,4,"Low",-5,5
"856",6,35,0,1.0717,31,35,2,7,3,2,5,2,4,"High",-5,5
"857",6,36,0,1.5006,121,35,9,7,0,3,3,3,4,"Low",2,2
"858",6,37,0,1.5392,16,31,2,2,0,4,4,4,4,"Low",0,0
"859",6,38,0,0.84529,118,46,7,5,1,3,4,3,4,"Low",2,2
"860",6,39,0,1.973,147,141,4,8,0,2,2,2,4,"Low",-4,4
"861",6,40,0,1.7246,141,100,8,5,3,0,3,0,4,"Low",3,3
"862",6,41,1,1.3661,89,83,7,8,2,3,5,2,4,"High",-1,1
"863",6,42,1,4.1775,104,19,8,5,1,1,2,1,4,"Low",3,3
"864",6,43,0,0.89727,43,71,7,10,3,0,3,0,4,"Low",-3,3
"865",6,44,0,1.2265,33,100,3,5,1,1,2,1,4,"Low",-2,2
"866",6,45,0,0.94373,33,27,3,4,2,0,2,0,4,"Low",-1,1
"867",6,46,1,1.7238,20,1,2,2,1,1,2,1,4,"Low",0,0
"868",6,47,0,1.0736,83,129,8,8,4,1,5,1,4,"High",0,0
"869",6,48,1,1.2278,146,40,9,7,3,2,5,3,4,"High",2,2
"870",6,49,1,3.5618,79,16,4,2,0,1,1,0,4,"Low",2,2
"871",6,50,1,1.6838,29,21,4,2,0,1,1,0,4,"Low",2,2
"872",6,51,0,7.1359,68,71,10,10,0,1,1,1,4,"Low",0,0
"873",6,52,0,1.69,50,19,2,5,1,2,3,2,4,"Low",-3,3
"874",6,53,1,1.5342,139,126,2,7,0,3,3,0,4,"Low",-5,5
"875",6,54,1,1.3674,146,43,9,7,4,4,8,4,4,"High",2,2
"876",6,55,1,1.0322,118,87,7,6,2,2,4,2,4,"Low",1,1
"877",6,56,0,0.63631,100,68,5,10,2,1,3,1,4,"Low",-5,5
"878",6,57,1,3.8016,19,21,5,2,3,2,5,3,4,"High",3,3
"879",6,58,0,7.8323,145,79,4,4,2,1,3,1,4,"Low",0,0
"880",6,59,1,0.77439,70,40,10,7,1,3,4,1,4,"Low",3,3
"881",6,60,1,1.583,46,121,5,9,4,1,5,4,4,"High",-4,4
"882",6,61,0,1.6706,33,21,3,2,3,3,6,3,4,"High",1,1
"883",6,62,0,0.95463,87,30,6,6,3,4,7,4,4,"High",0,0
"884",6,63,1,1.2091,112,44,5,3,2,2,4,2,4,"Low",2,2
"885",6,64,1,2.9774,20,114,2,1,2,1,3,2,4,"Low",1,1
"886",6,65,0,1.308,144,87,8,6,1,4,5,4,4,"High",2,2
"887",6,66,1,1.5353,126,78,7,3,4,0,4,4,4,"Low",4,4
"888",6,67,0,0.94748,89,68,7,10,3,2,5,2,4,"High",-3,3
"889",6,68,0,0.74057,40,45,7,5,4,2,6,2,4,"High",2,2
"890",6,69,1,7.6522,35,93,7,9,4,2,6,4,4,"High",-2,2
"891",6,70,1,1.3601,111,112,3,5,2,3,5,2,4,"High",-2,2
"892",6,71,1,0.96228,104,33,8,3,2,4,6,2,4,"High",5,5
"893",6,72,1,1.1078,112,144,5,8,4,2,6,4,4,"High",-3,3
"894",6,73,0,3.1504,71,69,10,10,2,1,3,1,4,"Low",0,0
"895",6,74,0,0.95548,103,29,2,4,0,1,1,1,4,"Low",-2,2
"896",6,75,1,2.3149,71,68,10,10,3,3,6,3,4,"High",0,0
"897",6,76,0,1.2843,77,44,2,3,1,3,4,3,4,"Low",-1,1
"898",6,77,0,0.91872,21,29,2,4,4,2,6,2,4,"High",-2,2
"899",6,78,1,2.2694,111,129,3,8,3,2,5,3,4,"High",-5,5
"900",6,79,0,3.0286,70,137,10,10,2,2,4,2,4,"Low",0,0
"901",6,80,0,1.1079,6,118,4,7,0,3,3,3,4,"Low",-3,3
"902",6,81,1,3.9647,127,141,3,8,1,4,5,1,4,"High",-5,5
"903",6,82,0,0.7174,6,27,4,4,1,1,2,1,4,"Low",0,0
"904",6,83,0,1.127,25,111,1,3,0,4,4,4,4,"Low",-2,2
"905",6,84,1,1.0074,70,143,10,10,3,0,3,3,4,"Low",0,0
"906",6,85,0,1.2617,147,19,4,5,1,4,5,4,4,"High",-1,1
"907",6,86,0,1.1649,25,74,1,1,1,0,1,0,4,"Low",0,0
"908",6,87,1,0.81491,27,77,4,2,2,2,4,2,4,"Low",2,2
"909",6,88,1,0.91523,74,78,1,3,1,1,2,1,4,"Low",-2,2
"910",6,89,0,1.6532,139,50,2,2,1,2,3,2,4,"Low",0,0
"911",6,90,1,0.66058,27,79,4,4,3,2,5,3,4,"High",0,0
"912",6,91,1,2.6005,77,1,2,2,3,2,5,3,4,"High",0,0
"913",6,92,1,1.1025,100,113,5,3,3,1,4,3,4,"Low",2,2
"914",6,93,0,0.71533,6,27,4,4,2,4,6,4,4,"High",0,0
"915",6,94,1,1.1899,45,89,5,7,3,4,7,3,4,"High",-2,2
"916",6,95,0,2.798,79,136,4,4,3,0,3,0,4,"Low",0,0
"917",6,96,0,1.5085,1,6,2,4,3,3,6,3,4,"High",-2,2
"918",6,97,1,0.82275,118,4,7,3,4,1,5,4,4,"High",4,4
"919",6,98,0,1.1975,34,45,6,5,1,4,5,4,4,"High",1,1
"920",6,99,1,1.1561,113,145,3,4,2,3,5,2,4,"High",-1,1
"921",6,100,0,2.5695,122,34,8,6,2,2,4,2,4,"Low",2,2
"922",6,101,0,1.0068,140,51,1,3,1,1,2,1,4,"Low",-2,2
"923",6,102,1,1.2777,4,140,3,1,2,2,4,2,4,"Low",2,2
"924",6,103,0,1.2963,6,77,4,2,4,4,8,4,4,"High",2,2
"925",6,104,0,1.3804,44,114,3,1,4,2,6,2,4,"High",2,2
"926",6,105,0,0.99635,145,50,4,2,4,3,7,3,4,"High",2,2
"927",6,106,1,1.4346,1,103,2,2,4,1,5,4,4,"High",0,0
"928",6,107,0,3.961,139,136,2,4,2,1,3,1,4,"Low",-2,2
"929",6,108,1,0.98507,34,25,6,1,3,2,5,3,4,"High",5,5
"930",6,109,1,1.2739,100,143,5,10,4,1,5,4,4,"High",-5,5
"931",6,110,1,0.7413,70,129,10,8,4,3,7,4,4,"High",2,2
"932",6,111,1,1.5646,50,16,2,2,4,2,6,4,4,"High",0,0
"933",6,112,1,0.82594,74,114,1,1,2,3,5,2,4,"High",0,0
"934",6,113,0,0.99413,147,20,4,2,2,3,5,3,4,"High",2,2
"935",6,114,1,0.66566,29,25,4,1,3,3,6,3,4,"High",3,3
"936",6,115,0,0.98194,121,69,9,10,2,2,4,2,4,"Low",-1,1
"937",6,116,1,0.63079,71,143,10,10,4,2,6,4,4,"High",0,0
"938",6,117,1,0.98153,74,147,1,4,3,3,6,3,4,"High",-3,3
"939",6,118,0,0.80748,78,29,3,4,2,4,6,4,4,"High",-1,1
"940",6,119,0,0.73637,147,79,4,4,4,4,8,4,4,"High",0,0
"941",6,120,1,0.77976,114,78,1,3,4,3,7,4,4,"High",-2,2
"942",6,121,1,1.7162,121,129,9,8,3,4,7,3,4,"High",1,1
"943",6,122,1,2.8385,4,16,3,2,3,3,6,3,4,"High",1,1
"944",6,123,0,0.65227,139,34,2,6,3,4,7,4,4,"High",-4,4
"945",6,124,1,1.6484,127,78,3,3,2,4,6,2,4,"High",0,0
"946",6,125,1,1.3712,16,25,2,1,4,4,8,4,4,"High",1,1
"947",6,126,0,0.97442,136,113,4,3,2,3,5,3,4,"High",1,1
"948",6,127,0,1.1498,144,4,8,3,3,4,7,4,4,"High",5,5
"949",6,128,1,0.82715,122,127,8,3,3,3,6,3,4,"High",5,5
"950",6,129,1,1.9286,139,103,2,2,4,2,6,4,4,"High",0,0
"951",6,130,0,1.018,136,20,4,2,3,4,7,4,4,"High",2,2
"952",6,131,0,0.8471,140,136,1,4,3,4,7,4,4,"High",-3,3
"953",6,132,0,1.2541,104,93,8,9,3,3,6,3,4,"High",-1,1
"954",6,133,1,0.70602,104,51,8,3,4,2,6,4,4,"High",5,5
"955",6,134,0,0.72413,144,68,8,10,4,4,8,4,4,"High",-2,2
"956",6,135,1,0.65607,51,103,3,2,3,3,6,3,4,"High",1,1
"957",6,136,1,1.1168,74,127,1,3,4,4,8,4,4,"High",-2,2
"958",6,137,1,0.8394,69,121,10,9,3,4,7,3,4,"High",1,1
"959",6,138,1,0.96446,113,103,3,2,4,4,8,4,4,"High",1,1
"960",6,139,0,0.79546,51,122,3,8,4,4,8,4,4,"High",-5,5
"961",6,140,1,0.61289,93,143,9,10,4,3,7,4,4,"High",-1,1
"962",6,141,1,0.73035,69,143,10,10,4,4,8,4,4,"High",0,0
"963",7,1,0,1.5297,45,100,10,10,0,0,0,0,4,"Low",0,0
"964",7,2,1,1.486,67,131,4,2,0,0,0,0,4,"Low",2,2
"965",7,3,1,1.3209,62,43,7,4,0,0,0,0,4,"Low",3,3
"966",7,4,1,2.3601,118,120,4,7,0,0,0,0,4,"Low",-3,3
"967",7,5,1,2.7691,11,135,6,2,0,0,0,0,4,"Low",4,4
"968",7,6,1,2.2318,58,27,2,7,0,0,0,0,4,"Low",-5,5
"969",7,7,0,3.0931,141,2,4,7,0,0,0,0,4,"Low",-3,3
"970",7,8,0,2.0396,77,147,4,3,0,0,0,0,4,"Low",1,1
"971",7,9,1,2.0039,106,95,2,4,0,0,0,0,4,"Low",-2,2
"972",7,10,0,1.0198,147,66,3,6,1,0,1,0,4,"Low",-3,3
"973",7,11,0,1.5946,67,21,4,7,1,0,1,0,4,"Low",-3,3
"974",7,12,0,3.6085,101,25,7,2,0,0,0,0,4,"Low",5,5
"975",7,13,1,1.2724,120,12,7,3,1,0,1,1,4,"Low",4,4
"976",7,14,1,1.1241,65,67,5,4,0,2,2,0,4,"Low",1,1
"977",7,15,1,1.9506,89,95,4,4,0,1,1,0,4,"Low",0,0
"978",7,16,1,1.5122,118,147,4,3,1,2,3,1,4,"Low",1,1
"979",7,17,0,2.0022,65,104,5,7,1,0,1,0,4,"Low",-2,2
"980",7,18,1,1.3793,21,94,7,4,1,0,1,1,4,"Low",3,3
"981",7,19,0,1.9394,135,11,2,6,1,1,2,1,4,"Low",-4,4
"982",7,20,1,1.6575,27,25,7,2,1,1,2,1,4,"Low",5,5
"983",7,21,0,1.391,12,67,3,4,1,3,4,3,4,"Low",-1,1
"984",7,22,1,1.2515,18,101,8,7,0,1,1,0,4,"Low",1,1
"985",7,23,1,1.2276,66,11,6,6,1,2,3,1,4,"Low",0,0
"986",7,24,0,1.8771,78,27,3,7,0,2,2,2,4,"Low",-4,4
"987",7,25,0,1.1545,131,58,2,2,1,1,2,1,4,"Low",0,0
"988",7,26,1,0.88568,46,53,10,5,0,0,0,0,4,"Low",5,5
"989",7,27,1,2.2594,143,135,5,2,0,2,2,0,4,"Low",3,3
"990",7,28,0,2.0436,58,120,2,7,2,2,4,2,4,"Low",-5,5
"991",7,29,1,1.7604,44,77,1,4,0,1,1,0,4,"Low",-3,3
"992",7,30,1,0.92576,21,126,7,3,2,0,2,2,4,"Low",4,4
"993",7,31,1,1.2254,104,141,7,4,1,1,2,1,4,"Low",3,3
"994",7,32,0,2.1819,66,104,6,7,2,2,4,2,4,"Low",-1,1
"995",7,33,1,2.2526,141,64,4,1,2,0,2,2,4,"Low",3,3
"996",7,34,1,2.1722,23,58,4,2,0,3,3,0,4,"Low",2,2
"997",7,35,1,1.0842,110,44,5,1,0,1,1,0,4,"Low",4,4
"998",7,36,1,1.3589,93,147,3,3,0,3,3,0,4,"Low",0,0
"999",7,37,0,1.0889,96,66,1,6,0,3,3,3,4,"Low",-5,5
"1000",7,38,1,2.4283,126,77,3,4,1,2,3,1,4,"Low",-1,1
"1001",7,39,0,1.8908,67,21,4,7,4,3,7,3,4,"High",-3,3
"1002",7,40,1,0.75032,18,27,8,7,1,3,4,1,4,"Low",1,1
"1003",7,41,1,1.0442,25,126,2,3,2,2,4,2,4,"Low",-1,1
"1004",7,42,1,1.127,4,142,3,1,0,0,0,0,4,"Low",2,2
"1005",7,43,0,1.5147,11,66,6,6,3,4,7,4,4,"High",0,0
"1006",7,44,0,1.2336,53,104,5,7,1,3,4,3,4,"Low",-2,2
"1007",7,45,1,1.6973,62,93,7,3,1,1,2,1,4,"Low",4,4
"1008",7,46,0,3.6208,86,118,7,4,0,2,2,2,4,"Low",3,3
"1009",7,47,1,1.0505,24,53,6,5,0,2,2,0,4,"Low",1,1
"1010",7,48,0,1.3198,25,110,2,5,3,1,4,1,4,"Low",-3,3
"1011",7,49,0,1.0673,65,100,5,10,2,1,3,1,4,"Low",-5,5
"1012",7,50,0,2.1509,101,24,7,6,2,1,3,1,4,"Low",1,1
"1013",7,51,0,1.1694,131,110,2,5,2,2,4,2,4,"Low",-3,3
"1014",7,52,0,1.304,2,23,7,4,1,1,2,1,4,"Low",3,3
"1015",7,53,0,1.2242,142,25,1,2,1,4,5,4,4,"High",-1,1
"1016",7,54,1,1.0704,65,114,5,1,3,0,3,3,4,"Low",4,4
"1017",7,55,0,1.5295,21,17,7,10,4,0,4,0,4,"Low",-3,3
"1018",7,56,1,2.9662,110,124,5,10,3,0,3,3,4,"Low",-5,5
"1019",7,57,0,0.99703,18,17,8,10,2,1,3,1,4,"Low",-2,2
"1020",7,58,1,1.7858,93,11,3,6,2,4,6,2,4,"High",-3,3
"1021",7,59,0,1.9463,142,77,1,4,2,3,5,3,4,"High",-3,3
"1022",7,60,0,0.89829,12,18,3,8,2,3,5,3,4,"High",-5,5
"1023",7,61,1,1.5883,79,53,10,5,0,3,3,0,4,"Low",5,5
"1024",7,62,1,1.2517,141,12,4,3,3,3,6,3,4,"High",1,1
"1025",7,63,0,1.0226,131,65,2,5,3,4,7,4,4,"High",-3,3
"1026",7,64,1,1.1325,23,142,4,1,2,3,5,2,4,"High",3,3
"1027",7,65,1,1.4833,78,12,3,3,1,4,5,1,4,"High",0,0
"1028",7,66,1,3.0616,131,94,2,4,4,1,5,4,4,"High",-2,2
"1029",7,67,1,1.1518,104,147,7,3,4,4,8,4,4,"High",4,4
"1030",7,68,1,1.5658,22,89,2,4,0,1,1,0,4,"Low",-2,2
"1031",7,69,0,1.3561,135,86,2,7,3,1,4,1,4,"Low",-5,5
"1032",7,70,1,1.4849,106,118,2,4,1,3,4,1,4,"Low",-2,2
"1033",7,71,1,1.6308,114,94,1,4,1,2,3,1,4,"Low",-3,3
"1034",7,72,1,2.5295,43,53,4,5,1,4,5,1,4,"High",-1,1
"1035",7,73,0,3.3275,95,44,4,1,2,2,4,2,4,"Low",3,3
"1036",7,74,1,1.3026,78,135,3,2,2,4,6,2,4,"High",1,1
"1037",7,75,1,2.613,101,126,7,3,3,3,6,3,4,"High",4,4
"1038",7,76,1,1.0904,110,45,5,10,4,1,5,4,4,"High",-5,5
"1039",7,77,1,1.3896,23,64,4,1,3,1,4,3,4,"Low",3,3
"1040",7,78,0,1.3919,118,93,4,3,4,3,7,3,4,"High",1,1
"1041",7,79,0,0.9619,94,2,4,7,3,2,5,2,4,"High",-3,3
"1042",7,80,1,0.75244,46,59,10,10,1,0,1,1,4,"Low",0,0
"1043",7,81,1,0.86196,79,17,10,10,1,2,3,1,4,"Low",0,0
"1044",7,82,1,2.0005,17,18,10,8,3,4,7,3,4,"High",2,2
"1045",7,83,1,3.5293,141,120,4,7,4,3,7,4,4,"High",-3,3
"1046",7,84,1,1.0579,58,94,2,4,4,4,8,4,4,"High",-2,2
"1047",7,85,1,6.9805,59,17,10,10,1,4,5,1,4,"High",0,0
"1048",7,86,0,1.2733,126,86,3,7,4,2,6,2,4,"High",-4,4
"1049",7,87,0,2.0914,86,22,7,2,3,1,4,1,4,"Low",5,5
"1050",7,88,1,0.9733,44,4,1,3,3,1,4,3,4,"Low",-2,2
"1051",7,89,1,3.0376,124,143,10,5,1,1,2,1,4,"Low",5,5
"1052",7,90,1,0.73482,93,2,3,7,4,3,7,4,4,"High",-4,4
"1053",7,91,0,1.4138,142,22,1,2,4,2,6,2,4,"High",-1,1
"1054",7,92,0,2.7728,89,106,4,2,2,2,4,2,4,"Low",2,2
"1055",7,93,1,0.99174,23,4,4,3,4,2,6,4,4,"High",1,1
"1056",7,94,1,1.1825,27,45,7,10,4,2,6,4,4,"High",-3,3
"1057",7,95,0,2.4263,143,22,5,2,2,3,5,3,4,"High",3,3
"1058",7,96,0,1.0639,124,79,10,10,2,2,4,2,4,"Low",0,0
"1059",7,97,0,1.0264,22,24,2,6,4,2,6,2,4,"High",-4,4
"1060",7,98,0,1.2133,95,62,4,7,3,2,5,2,4,"High",-3,3
"1061",7,99,0,0.98051,96,24,1,6,1,3,4,3,4,"Low",-5,5
"1062",7,100,0,2.4638,120,62,7,7,4,3,7,3,4,"High",0,0
"1063",7,101,1,1.1255,2,45,7,10,4,3,7,4,4,"High",-3,3
"1064",7,102,0,1.7446,114,44,1,1,2,4,6,4,4,"High",0,0
"1065",7,103,0,1.9448,4,114,3,1,3,3,6,3,4,"High",2,2
"1066",7,104,1,1.4361,101,106,7,2,4,3,7,4,4,"High",5,5
"1067",7,105,0,1.0242,45,46,10,10,4,2,6,2,4,"High",0,0
"1068",7,106,1,1.3123,59,124,10,10,2,3,5,2,4,"High",0,0
"1069",7,107,0,1.7109,106,86,2,7,4,4,8,4,4,"High",-5,5
"1070",7,108,0,2.8776,95,24,4,6,4,4,8,4,4,"High",-2,2
"1071",7,109,1,1.2104,143,77,5,4,3,4,7,3,4,"High",1,1
"1072",7,110,0,3.073,46,59,10,10,3,3,6,3,4,"High",0,0
"1073",7,111,0,1.9471,4,43,3,4,4,2,6,2,4,"High",-1,1
"1074",7,112,0,1.5372,64,89,1,4,2,3,5,3,4,"High",-3,3
"1075",7,113,1,0.75854,79,100,10,10,3,2,5,3,4,"High",0,0
"1076",7,114,0,1.0499,124,59,10,10,4,4,8,4,4,"High",0,0
"1077",7,115,0,4.3578,79,62,10,7,4,4,8,4,4,"High",3,3
"1078",7,116,0,2.0821,143,43,5,4,4,3,7,3,4,"High",1,1
"1079",7,117,1,1.0931,43,78,4,3,4,3,7,4,4,"High",1,1
"1080",7,118,1,1.1486,89,78,4,3,4,4,8,4,4,"High",1,1
"1081",7,119,0,1.7973,64,96,1,1,3,2,5,2,4,"High",0,0
"1082",7,120,0,2.8896,114,96,1,1,4,3,7,3,4,"High",0,0
"1083",7,121,0,5.6807,100,46,10,10,3,4,7,4,4,"High",0,0
"1084",7,122,0,0.9147,64,96,1,1,4,4,8,4,4,"High",0,0
"1085",8,1,0,1.1558,6,120,3,4,0,0,0,0,4,"Low",-1,1
"1086",8,2,1,2.4102,18,32,5,6,0,0,0,0,4,"Low",-1,1
"1087",8,3,0,1.2693,133,118,4,5,0,0,0,0,4,"Low",-1,1
"1088",8,4,0,1.4944,32,46,6,10,1,0,1,0,4,"Low",-4,4
"1089",8,5,0,1.2628,123,143,4,3,0,0,0,0,4,"Low",1,1
"1090",8,6,0,1.0344,68,46,7,10,0,1,1,1,4,"Low",-3,3
"1091",8,7,1,3.233,110,123,2,4,0,1,1,0,4,"Low",-2,2
"1092",8,8,1,1.2052,20,119,10,5,0,0,0,0,4,"Low",5,5
"1093",8,9,1,1.9198,8,89,9,10,0,0,0,0,4,"Low",-1,1
"1094",8,10,0,1.3554,36,120,3,4,0,1,1,1,4,"Low",-1,1
"1095",8,11,1,0.95203,41,105,9,4,0,0,0,0,4,"Low",5,5
"1096",8,12,1,0.99746,25,4,5,3,0,0,0,0,4,"Low",2,2
"1097",8,13,0,1.0954,97,88,3,2,0,0,0,0,4,"Low",1,1
"1098",8,14,0,1.2975,27,82,5,9,0,0,0,0,4,"Low",-4,4
"1099",8,15,1,1.0761,58,102,10,5,0,0,0,0,4,"Low",5,5
"1100",8,16,1,2.1116,63,143,6,3,0,1,1,0,4,"Low",3,3
"1101",8,17,0,2.7219,70,71,3,3,0,0,0,0,4,"Low",0,0
"1102",8,18,0,2.4509,114,124,9,10,0,0,0,0,4,"Low",-1,1
"1103",8,19,0,1.6816,8,100,9,10,1,0,1,0,4,"Low",-1,1
"1104",8,20,1,1.3056,101,27,10,5,0,1,1,0,4,"Low",5,5
"1105",8,21,1,2.2758,45,29,10,10,0,0,0,0,4,"Low",0,0
"1106",8,22,0,1.3292,93,31,10,10,0,0,0,0,4,"Low",0,0
"1107",8,23,0,1.8633,17,67,5,5,0,0,0,0,4,"Low",0,0
"1108",8,24,1,1.2792,67,105,5,4,1,1,2,1,4,"Low",1,1
"1109",8,25,1,1.7932,103,105,9,4,0,2,2,0,4,"Low",5,5
"1110",8,26,0,1.3382,49,118,1,5,0,1,1,1,4,"Low",-4,4
"1111",8,27,0,1.1142,97,27,3,5,1,2,3,2,4,"Low",-2,2
"1112",8,28,1,2.5934,103,123,9,4,1,2,3,1,4,"Low",5,5
"1113",8,29,1,3.0497,137,69,4,3,0,0,0,0,4,"Low",1,1
"1114",8,30,0,3.9123,4,27,3,5,1,3,4,3,4,"Low",-2,2
"1115",8,31,1,1.5099,93,114,10,9,1,1,2,1,4,"Low",1,1
"1116",8,32,0,1.1618,18,129,5,10,1,0,1,0,4,"Low",-5,5
"1117",8,33,1,1.054,129,8,10,9,1,2,3,1,4,"Low",1,1
"1118",8,34,0,3.3392,101,31,10,10,1,1,2,1,4,"Low",0,0
"1119",8,35,1,2.514,134,56,5,1,0,0,0,0,4,"Low",4,4
"1120",8,36,0,1.1995,114,45,9,10,2,1,3,1,4,"Low",-1,1
"1121",8,37,0,1.4802,27,88,5,2,4,1,5,1,4,"High",3,3
"1122",8,38,0,1.7967,133,4,4,3,1,2,3,2,4,"Low",1,1
"1123",8,39,0,2.4169,101,25,10,5,2,1,3,1,4,"Low",5,5
"1124",8,40,1,1.7183,120,123,4,4,2,3,5,2,4,"High",0,0
"1125",8,41,1,1.7496,104,123,4,4,0,4,4,0,4,"Low",0,0
"1126",8,42,0,1.7422,56,47,1,3,1,0,1,0,4,"Low",-2,2
"1127",8,43,1,1.4477,114,18,9,5,3,2,5,3,4,"High",4,4
"1128",8,44,0,3.0929,56,71,1,3,2,1,3,1,4,"Low",-2,2
"1129",8,45,0,3.1329,79,11,4,3,0,0,0,0,4,"Low",1,1
"1130",8,46,1,1.0793,138,18,10,5,0,3,3,0,4,"Low",5,5
"1131",8,47,0,1.1502,71,25,3,5,2,2,4,2,4,"Low",-2,2
"1132",8,48,0,1.288,106,7,2,2,0,0,0,0,4,"Low",0,0
"1133",8,49,1,0.94719,129,103,10,9,2,2,4,2,4,"Low",1,1
"1134",8,50,0,0.90131,18,101,5,10,4,3,7,3,4,"High",-5,5
"1135",8,51,0,1.2996,110,118,2,5,1,2,3,2,4,"Low",-3,3
"1136",8,52,0,3.4918,24,110,1,2,0,2,2,2,4,"Low",-1,1
"1137",8,53,1,2.377,32,104,6,4,2,1,3,2,4,"Low",2,2
"1138",8,54,0,1.8845,63,70,6,3,1,1,2,1,4,"Low",3,3
"1139",8,55,1,2.1305,115,127,5,3,0,0,0,0,4,"Low",2,2
"1140",8,56,0,1.2473,143,25,3,5,2,3,5,3,4,"High",-2,2
"1141",8,57,0,1.1347,6,32,3,6,1,3,4,3,4,"Low",-3,3
"1142",8,58,0,1.4139,105,114,4,9,3,4,7,4,4,"High",-5,5
"1143",8,59,0,2.3248,133,110,4,2,2,3,5,3,4,"High",2,2
"1144",8,60,0,1.2742,11,119,3,5,1,1,2,1,4,"Low",-2,2
"1145",8,61,0,2.8187,98,79,1,4,0,1,1,1,4,"Low",-3,3
"1146",8,62,0,0.96286,133,63,4,6,3,2,5,2,4,"High",-2,2
"1147",8,63,1,1.8015,118,104,5,4,3,2,5,3,4,"High",1,1
"1148",8,64,0,1.243,110,127,2,3,4,1,5,1,4,"High",-1,1
"1149",8,65,1,1.2397,102,7,5,2,1,1,2,1,4,"Low",3,3
"1150",8,66,0,0.90573,93,25,10,5,2,4,6,4,4,"High",5,5
"1151",8,67,1,2.4132,63,143,6,3,3,3,6,3,4,"High",3,3
"1152",8,68,1,1.1571,134,127,5,3,1,2,3,1,4,"Low",2,2
"1153",8,69,0,1.2137,68,58,7,10,1,1,2,1,4,"Low",-3,3
"1154",8,70,0,2.4465,137,98,4,1,1,1,2,1,4,"Low",3,3
"1155",8,71,0,1.354,102,36,5,3,2,1,3,1,4,"Low",2,2
"1156",8,72,1,0.98057,41,115,9,5,1,1,2,1,4,"Low",4,4
"1157",8,73,0,1.078,105,134,4,5,4,2,6,2,4,"High",-1,1
"1158",8,74,0,1.5622,70,115,3,5,2,2,4,2,4,"Low",-2,2
"1159",8,75,1,2.2068,133,61,4,2,4,0,4,4,4,"Low",2,2
"1160",8,76,1,0.71086,67,120,5,4,2,3,5,2,4,"High",1,1
"1161",8,77,1,1.135,34,45,10,10,0,2,2,0,4,"Low",0,0
"1162",8,78,1,0.90036,134,4,5,3,3,3,6,3,4,"High",2,2
"1163",8,79,1,1.5238,99,61,3,2,0,1,1,0,4,"Low",1,1
"1164",8,80,0,1.0691,106,11,2,3,1,2,3,2,4,"Low",-1,1
"1165",8,81,1,4.199,46,45,10,10,2,3,5,2,4,"High",0,0
"1166",8,82,0,1.8879,4,134,3,5,4,4,8,4,4,"High",-2,2
"1167",8,83,1,1.2805,138,29,10,10,1,1,2,1,4,"Low",0,0
"1168",8,84,0,0.8111,93,89,10,10,3,1,4,1,4,"Low",0,0
"1169",8,85,1,2.328,127,120,3,4,3,4,7,3,4,"High",-1,1
"1170",8,86,0,1.0368,61,79,2,4,2,2,4,2,4,"Low",-2,2
"1171",8,87,1,2.6982,63,119,6,5,4,2,6,4,4,"High",1,1
"1172",8,88,1,1.289,127,24,3,1,4,1,5,4,4,"High",2,2
"1173",8,89,1,1.2247,102,118,5,5,3,4,7,3,4,"High",0,0
"1174",8,90,0,1.6705,119,102,5,5,3,4,7,4,4,"High",0,0
"1175",8,91,0,1.059,61,112,2,3,3,0,3,0,4,"Low",-1,1
"1176",8,92,1,1.4682,11,6,3,3,3,2,5,3,4,"High",0,0
"1177",8,93,1,2.2056,11,7,3,2,4,2,6,4,4,"High",1,1
"1178",8,94,0,1.7723,68,30,7,10,2,0,2,0,4,"Low",-3,3
"1179",8,95,1,1.5806,98,71,1,3,2,3,5,2,4,"High",-2,2
"1180",8,96,1,0.93845,103,8,9,9,3,3,6,3,4,"High",0,0
"1181",8,97,1,0.66072,99,115,3,5,1,3,4,1,4,"Low",-2,2
"1182",8,98,1,1.3586,101,41,10,9,4,2,6,4,4,"High",1,1
"1183",8,99,0,1.4254,29,46,10,10,2,3,5,3,4,"High",0,0
"1184",8,100,1,1.156,41,79,9,4,3,3,6,3,4,"High",5,5
"1185",8,101,1,0.83018,31,103,10,9,2,4,6,2,4,"High",1,1
"1186",8,102,1,0.78827,65,82,10,9,0,1,1,0,4,"Low",1,1
"1187",8,103,0,1.1666,119,100,5,10,4,1,5,1,4,"High",-5,5
"1188",8,104,1,0.84117,99,71,3,3,2,4,6,2,4,"High",0,0
"1189",8,105,1,3.0191,82,89,9,10,2,2,4,2,4,"Low",-1,1
"1190",8,106,1,3.8039,31,138,10,10,3,2,5,3,4,"High",0,0
"1191",8,107,0,3.7142,47,17,3,5,1,1,2,1,4,"Low",-2,2
"1192",8,108,0,6.8679,113,82,9,9,0,3,3,3,4,"Low",0,0
"1193",8,109,0,0.89013,93,129,10,10,4,3,7,3,4,"High",0,0
"1194",8,110,0,2.8663,49,106,1,2,1,2,3,2,4,"Low",-1,1
"1195",8,111,1,1.3162,113,115,9,5,1,4,5,1,4,"High",4,4
"1196",8,112,1,3.1214,49,69,1,3,2,1,3,2,4,"Low",-2,2
"1197",8,113,0,1.2144,49,47,1,3,3,2,5,2,4,"High",-2,2
"1198",8,114,1,1.1349,46,35,10,10,4,0,4,4,4,"Low",0,0
"1199",8,115,1,1.3963,112,137,3,4,1,2,3,1,4,"Low",-1,1
"1200",8,116,1,3.6386,82,89,9,10,4,3,7,4,4,"High",-1,1
"1201",8,117,0,5.3391,20,31,10,10,1,4,5,4,4,"High",0,0
"1202",8,118,1,1.156,47,61,3,2,3,4,7,3,4,"High",1,1
"1203",8,119,1,2.0349,35,30,10,10,1,1,2,1,4,"Low",0,0
"1204",8,120,0,0.91221,113,58,9,10,2,2,4,2,4,"Low",-1,1
"1205",8,121,1,1.3865,20,100,10,10,2,2,4,2,4,"Low",0,0
"1206",8,122,1,1.1657,138,29,10,10,3,3,6,3,4,"High",0,0
"1207",8,123,1,1.5745,124,29,10,10,1,4,5,1,4,"High",0,0
"1208",8,124,1,2.5738,113,104,9,4,3,3,6,3,4,"High",5,5
"1209",8,125,0,4.1558,137,70,4,3,3,3,6,3,4,"High",1,1
"1210",8,126,0,1.2283,36,67,3,5,2,3,5,3,4,"High",-2,2
"1211",8,127,0,2.3475,30,96,10,10,2,0,2,0,4,"Low",0,0
"1212",8,128,1,2.3941,137,24,4,1,4,2,6,4,4,"High",3,3
"1213",8,129,1,1.1549,20,30,10,10,3,3,6,3,4,"High",0,0
"1214",8,130,0,1.128,6,98,3,1,3,3,6,3,4,"High",2,2
"1215",8,131,0,1.2275,49,97,1,3,4,2,6,2,4,"High",-2,2
"1216",8,132,0,2.3521,20,58,10,10,4,3,7,3,4,"High",0,0
"1217",8,133,0,1.3597,97,32,3,6,3,4,7,4,4,"High",-3,3
"1218",8,134,0,0.96028,17,41,5,9,2,4,6,4,4,"High",-4,4
"1219",8,135,1,0.8825,58,67,10,5,4,4,8,4,4,"High",5,5
"1220",8,136,0,1.7188,106,104,2,4,3,4,7,4,4,"High",-2,2
"1221",8,137,1,1.9038,88,97,2,3,2,4,6,2,4,"High",-1,1
"1222",8,138,0,1.3165,30,96,10,10,4,1,5,1,4,"High",0,0
"1223",8,139,1,1.2346,35,100,10,10,2,3,5,2,4,"High",0,0
"1224",8,140,0,1.0678,69,112,3,3,2,2,4,2,4,"Low",0,0
"1225",8,141,1,2.6586,98,79,1,4,4,4,8,4,4,"High",-3,3
"1226",8,142,1,1.0667,68,106,7,2,3,4,7,3,4,"High",5,5
"1227",8,143,1,1.1614,6,24,3,1,4,3,7,4,4,"High",2,2
"1228",8,144,0,1.4135,99,68,3,7,3,4,7,4,4,"High",-4,4
"1229",8,145,0,1.2782,89,138,10,10,4,4,8,4,4,"High",0,0
"1230",8,146,0,1.2248,17,45,5,10,3,4,7,4,4,"High",-5,5
"1231",8,147,0,1.606,56,88,1,2,3,3,6,3,4,"High",-1,1
"1232",8,148,0,1.0498,24,112,1,3,4,3,7,3,4,"High",-2,2
"1233",8,149,0,2.0696,124,34,10,10,2,1,3,1,4,"Low",0,0
"1234",8,150,1,0.94328,129,17,10,5,4,4,8,4,4,"High",5,5
"1235",8,151,1,1.166,143,7,3,2,4,3,7,4,4,"High",1,1
"1236",8,152,1,1.1974,47,70,3,3,4,4,8,4,4,"High",0,0
"1237",8,153,1,0.84935,100,124,10,10,4,3,7,4,4,"High",0,0
"1238",8,154,0,1.6868,8,124,9,10,4,4,8,4,4,"High",-1,1
"1239",8,155,0,1.1322,7,88,2,2,4,4,8,4,4,"High",0,0
"1240",8,156,0,3.0908,36,69,3,3,3,3,6,3,4,"High",0,0
"1241",8,157,1,2.1831,99,56,3,1,4,4,8,4,4,"High",2,2
"1242",8,158,1,1.417,96,35,10,10,2,3,5,2,4,"High",0,0
"1243",8,159,0,1.4019,66,96,10,10,0,3,3,3,4,"Low",0,0
"1244",8,160,1,1.723,34,66,10,10,2,1,3,2,4,"Low",0,0
"1245",8,161,1,1.9865,35,66,10,10,4,2,6,4,4,"High",0,0
"1246",8,162,0,1.4818,113,96,9,10,4,4,8,4,4,"High",-1,1
"1247",8,163,0,1.0518,66,34,10,10,3,3,6,3,4,"High",0,0
"1248",8,164,1,2.1099,69,36,3,3,4,4,8,4,4,"High",0,0
"1249",8,165,1,1.2919,34,65,10,10,4,1,5,4,4,"High",0,0
"1250",8,166,0,1.5766,66,65,10,10,4,2,6,2,4,"High",0,0
"1251",9,1,0,1.3517,44,141,2,3,0,0,0,0,4,"Low",-1,1
"1252",9,2,0,0.96839,147,11,1,3,0,0,0,0,4,"Low",-2,2
"1253",9,3,0,1.001,117,127,1,3,0,0,0,0,4,"Low",-2,2
"1254",9,4,1,1.2124,108,53,2,1,0,0,0,0,4,"Low",1,1
"1255",9,5,0,1.0413,43,71,6,7,0,0,0,0,4,"Low",-1,1
"1256",9,6,1,4.8313,55,117,2,1,0,1,1,0,4,"Low",1,1
"1257",9,7,0,0.70259,86,68,1,5,0,0,0,0,4,"Low",-4,4
"1258",9,8,0,1.2445,120,3,1,5,0,0,0,0,4,"Low",-4,4
"1259",9,9,0,1.3288,117,86,1,1,2,1,3,1,4,"Low",0,0
"1260",9,10,1,1.5434,19,120,3,1,0,1,1,0,4,"Low",2,2
"1261",9,11,0,0.60746,147,70,1,6,1,0,1,0,4,"Low",-5,5
"1262",9,12,0,1.3653,55,143,2,3,1,0,1,0,4,"Low",-1,1
"1263",9,13,1,2.2029,11,106,3,2,1,0,1,1,4,"Low",1,1
"1264",9,14,1,1.6567,86,106,1,2,2,1,3,2,4,"Low",-1,1
"1265",9,15,0,32.2526,71,70,7,6,1,1,2,1,4,"Low",1,1
"1266",9,16,1,1.1056,4,147,3,1,0,2,2,0,4,"Low",2,2
"1267",9,17,0,0.97956,147,47,1,3,3,0,3,0,4,"Low",-2,2
"1268",9,18,0,1.0821,47,108,3,2,1,1,2,1,4,"Low",1,1
"1269",9,19,0,0.91825,142,43,2,6,0,1,1,1,4,"Low",-4,4
"1270",9,20,0,0.60171,4,71,3,7,1,2,3,2,4,"Low",-4,4
"1271",9,21,0,2.0909,30,117,2,1,0,3,3,3,4,"Low",1,1
"1272",9,22,0,0.73432,30,4,2,3,1,2,3,2,4,"Low",-1,1
"1273",9,23,0,1.0945,55,43,2,6,2,2,4,2,4,"Low",-4,4
"1274",9,24,0,1.0431,3,135,5,4,1,0,1,0,4,"Low",1,1
"1275",9,25,0,1.4158,44,11,2,3,1,2,3,2,4,"Low",-1,1
"1276",9,26,1,0.76326,4,13,3,1,3,0,3,3,4,"Low",2,2
"1277",9,27,1,1.08,142,30,2,2,1,2,3,1,4,"Low",0,0
"1278",9,28,1,1.0252,68,141,5,3,1,1,2,1,4,"Low",2,2
"1279",9,29,0,4.2057,106,95,2,2,2,0,2,0,4,"Low",0,0
"1280",9,30,1,66.5443,141,108,3,2,2,2,4,2,4,"Low",1,1
"1281",9,31,0,0.644,117,69,1,6,4,0,4,0,4,"Low",-5,5
"1282",9,32,0,0.72855,55,143,2,3,3,1,4,1,4,"Low",-1,1
"1283",9,33,1,0.77805,3,6,5,4,2,0,2,2,4,"Low",1,1
"1284",9,34,0,0.71345,4,71,3,7,4,3,7,3,4,"High",-4,4
"1285",9,35,0,0.77886,86,69,1,6,3,1,4,1,4,"Low",-5,5
"1286",9,36,1,1.0339,71,19,7,3,4,1,5,4,4,"High",4,4
"1287",9,37,0,0.52683,86,70,1,6,4,2,6,2,4,"High",-5,5
"1288",9,38,1,0.78962,3,127,5,3,3,1,4,3,4,"Low",2,2
"1289",9,39,0,0.80634,120,6,1,4,2,1,3,1,4,"Low",-3,3
"1290",9,40,0,3.8707,11,3,3,5,3,4,7,4,4,"High",-2,2
"1291",9,41,0,0.55839,30,68,2,5,3,2,5,2,4,"High",-3,3
"1292",9,42,0,2.3581,44,142,2,2,2,2,4,2,4,"Low",0,0
"1293",9,43,0,0.52557,55,137,2,5,4,0,4,0,4,"Low",-3,3
"1294",9,44,1,2.015,95,44,2,2,1,3,4,1,4,"Low",0,0
"1295",9,45,0,1.059,127,19,3,3,2,2,4,2,4,"Low",0,0
"1296",9,46,0,0.55106,11,137,3,5,4,1,5,1,4,"High",-2,2
"1297",9,47,1,2.1752,47,7,3,3,2,0,2,2,4,"Low",0,0
"1298",9,48,0,1.0784,120,95,1,2,3,2,5,2,4,"High",-1,1
"1299",9,49,1,0.85803,69,120,6,1,2,4,6,2,4,"High",5,5
"1300",9,50,0,0.65441,147,7,1,3,4,1,5,1,4,"High",-2,2
"1301",9,51,0,0.90916,127,141,3,3,3,3,6,3,4,"High",0,0
"1302",9,52,0,0.91193,44,137,2,5,4,2,6,2,4,"High",-3,3
"1303",9,53,1,1.8405,19,141,3,3,3,4,7,3,4,"High",0,0
"1304",9,54,1,1.3707,6,7,4,3,2,2,4,2,4,"Low",1,1
"1305",9,55,1,1.2075,95,106,2,2,3,3,6,3,4,"High",0,0
"1306",9,56,1,1.2132,135,106,4,2,1,4,5,1,4,"High",2,2
"1307",9,57,1,3.569,7,13,3,1,3,1,4,3,4,"Low",2,2
"1308",9,58,0,0.58559,143,69,3,6,2,3,5,3,4,"High",-3,3
"1309",9,59,1,0.49094,70,47,6,3,3,3,6,3,4,"High",3,3
"1310",9,60,1,0.63757,70,108,6,2,4,3,7,4,4,"High",4,4
"1311",9,61,1,0.71022,127,30,3,2,4,4,8,4,4,"High",1,1
"1312",9,62,0,0.67768,142,108,2,2,3,4,7,4,4,"High",0,0
"1313",9,63,1,0.659,68,7,5,3,3,4,7,3,4,"High",2,2
"1314",9,64,0,2.0684,6,143,4,3,3,3,6,3,4,"High",1,1
"1315",9,65,1,0.62383,68,13,5,1,4,2,6,4,4,"High",4,4
"1316",9,66,1,0.74113,135,13,4,1,2,3,5,2,4,"High",3,3
"1317",9,67,1,0.83041,69,19,6,3,4,4,8,4,4,"High",3,3
"1318",9,68,0,1.0031,143,43,3,6,4,3,7,3,4,"High",-3,3
"1319",9,69,1,0.81713,142,13,2,1,4,4,8,4,4,"High",1,1
"1320",9,70,1,1.0386,135,6,4,4,3,4,7,3,4,"High",0,0
"1321",9,71,0,2.5793,107,95,5,2,0,4,4,4,4,"Low",3,3
"1322",9,72,1,0.6018,137,47,5,3,3,4,7,3,4,"High",2,2
"1323",9,73,1,0.81598,43,107,6,5,4,1,5,4,4,"High",1,1
"1324",9,74,0,0.82735,107,135,5,4,2,4,6,4,4,"High",1,1
"1325",9,75,1,0.54531,137,107,5,5,4,3,7,4,4,"High",0,0
"1326",9,76,1,1.1926,107,53,5,1,4,1,5,4,4,"High",4,4
"1327",10,1,1,1.321,146,91,10,6,0,0,0,0,4,"Low",4,4
"1328",10,2,0,1.0361,69,2,3,8,0,0,0,0,4,"Low",-5,5
"1329",10,3,1,1.0444,90,44,6,7,0,0,0,0,4,"Low",-1,1
"1330",10,4,0,1.2428,105,47,5,6,0,0,0,0,4,"Low",-1,1
"1331",10,5,0,1.349,68,2,5,8,0,1,1,1,4,"Low",-3,3
"1332",10,6,1,0.92522,122,101,8,6,0,0,0,0,4,"Low",2,2
"1333",10,7,0,1.5103,36,21,4,4,0,0,0,0,4,"Low",0,0
"1334",10,8,0,3.0271,47,46,6,8,1,0,1,0,4,"Low",-2,2
"1335",10,9,1,2.0859,121,27,9,5,0,0,0,0,4,"Low",4,4
"1336",10,10,1,1.5614,27,100,5,2,1,0,1,1,4,"Low",3,3
"1337",10,11,0,1.744,20,52,3,5,0,0,0,0,4,"Low",-2,2
"1338",10,12,1,2.2641,34,70,10,6,0,0,0,0,4,"Low",4,4
"1339",10,13,0,2.0276,67,73,5,10,0,0,0,0,4,"Low",-5,5
"1340",10,14,1,1.5464,39,48,9,5,0,0,0,0,4,"Low",4,4
"1341",10,15,1,1.3095,89,52,7,5,0,1,1,0,4,"Low",2,2
"1342",10,16,0,1.3811,20,125,3,7,1,0,1,0,4,"Low",-4,4
"1343",10,17,0,1.3098,45,54,8,6,0,0,0,0,4,"Low",2,2
"1344",10,18,1,0.84791,146,134,10,7,1,0,1,1,4,"Low",3,3
"1345",10,19,1,1.5146,101,27,6,5,1,2,3,1,4,"Low",1,1
"1346",10,20,0,1.3205,124,105,4,5,0,1,1,1,4,"Low",-1,1
"1347",10,21,1,1.2946,71,145,5,2,0,0,0,0,4,"Low",3,3
"1348",10,22,0,4.3838,87,122,10,8,0,1,1,1,4,"Low",2,2
"1349",10,23,1,0.97136,71,124,5,4,1,1,2,1,4,"Low",1,1
"1350",10,24,0,0.94663,40,137,1,3,0,0,0,0,4,"Low",-2,2
"1351",10,25,0,1.0304,66,83,5,10,0,0,0,0,4,"Low",-5,5
"1352",10,26,1,1.4661,123,40,4,1,0,1,1,0,4,"Low",3,3
"1353",10,27,0,1.2883,48,69,5,3,1,1,2,1,4,"Low",2,2
"1354",10,28,0,1.4217,84,122,10,8,0,2,2,2,4,"Low",2,2
"1355",10,29,0,1.475,47,89,6,7,2,1,3,1,4,"Low",-1,1
"1356",10,30,0,3.4715,76,49,3,5,0,0,0,0,4,"Low",-2,2
"1357",10,31,1,1.0906,125,124,7,4,1,2,3,1,4,"Low",3,3
"1358",10,32,1,1.8811,8,71,6,5,0,2,2,0,4,"Low",1,1
"1359",10,33,1,0.94857,113,73,7,10,0,1,1,0,4,"Low",-3,3
"1360",10,34,1,2.0924,30,1,8,8,0,0,0,0,4,"Low",0,0
"1361",10,35,0,1.5986,118,74,5,6,0,0,0,0,4,"Low",-1,1
"1362",10,36,1,1.3826,1,90,8,6,1,1,2,1,4,"Low",2,2
"1363",10,37,0,3.9695,99,85,2,7,0,0,0,0,4,"Low",-5,5
"1364",10,38,1,1.329,111,90,8,6,0,2,2,0,4,"Low",2,2
"1365",10,39,1,1.3572,99,49,2,5,1,1,2,1,4,"Low",-3,3
"1366",10,40,0,2.2214,143,89,3,7,0,2,2,2,4,"Low",-4,4
"1367",10,41,1,1.1291,113,105,7,5,1,2,3,1,4,"Low",2,2
"1368",10,42,1,1.0291,34,79,10,5,1,0,1,1,4,"Low",5,5
"1369",10,43,1,1.1691,39,133,9,8,1,0,1,1,4,"Low",1,1
"1370",10,44,0,1.0425,138,35,8,10,0,0,0,0,4,"Low",-2,2
"1371",10,45,1,1.2298,122,84,8,10,3,1,4,3,4,"Low",-2,2
"1372",10,46,0,1.3792,69,133,3,8,2,1,3,1,4,"Low",-5,5
"1373",10,47,1,1.7412,52,67,5,5,2,1,3,2,4,"Low",0,0
"1374",10,48,1,0.82868,121,71,9,5,1,3,4,1,4,"Low",4,4
"1375",10,49,0,1.9486,84,140,10,9,2,0,2,0,4,"Low",1,1
"1376",10,50,1,1.404,89,8,7,6,3,1,4,3,4,"Low",1,1
"1377",10,51,0,5.0774,72,44,5,7,0,1,1,1,4,"Low",-2,2
"1378",10,52,1,4.3058,80,100,4,2,0,1,1,0,4,"Low",2,2
"1379",10,53,0,1.3319,138,132,8,8,1,0,1,0,4,"Low",0,0
"1380",10,54,1,0.78971,146,112,10,8,2,0,2,2,4,"Low",2,2
"1381",10,55,1,1.3909,66,105,5,5,1,3,4,1,4,"Low",0,0
"1382",10,56,0,0.91448,43,83,7,10,0,1,1,1,4,"Low",-3,3
"1383",10,57,0,1.0013,90,51,6,7,3,0,3,0,4,"Low",-1,1
"1384",10,58,1,1.1411,138,58,8,5,2,0,2,2,4,"Low",3,3
"1385",10,59,1,0.9274,55,71,7,5,0,4,4,0,4,"Low",2,2
"1386",10,60,0,1.1285,58,84,5,10,1,3,4,3,4,"Low",-5,5
"1387",10,61,1,1.2101,97,48,3,5,0,2,2,0,4,"Low",-2,2
"1388",10,62,0,1.0407,43,139,7,8,1,0,1,0,4,"Low",-1,1
"1389",10,63,1,1.004,74,27,6,5,1,3,4,1,4,"Low",1,1
"1390",10,64,1,2.0928,124,78,4,4,3,0,3,3,4,"Low",0,0
"1391",10,65,0,2.8108,57,29,8,9,0,0,0,0,4,"Low",-1,1
"1392",10,66,0,2.0983,55,132,7,8,1,1,2,1,4,"Low",-1,1
"1393",10,67,0,1.1111,123,139,4,8,1,1,2,1,4,"Low",-4,4
"1394",10,68,1,2.845,92,30,7,8,0,1,1,0,4,"Low",-1,1
"1395",10,69,1,1.5191,21,38,4,2,1,0,1,1,4,"Low",2,2
"1396",10,70,1,1.1943,67,58,5,5,2,2,4,2,4,"Low",0,0
"1397",10,71,1,1.4343,46,24,8,6,1,0,1,1,4,"Low",2,2
"1398",10,72,0,1.7474,145,80,2,4,1,1,2,1,4,"Low",-2,2
"1399",10,73,0,1.2698,48,66,5,5,3,2,5,2,4,"High",0,0
"1400",10,74,0,1.2167,66,54,5,6,3,1,4,1,4,"Low",-1,1
"1401",10,75,1,1.5592,47,25,6,8,3,0,3,3,4,"Low",-2,2
"1402",10,76,1,1.3248,80,79,4,5,2,1,3,2,4,"Low",-1,1
"1403",10,77,0,1.5281,79,27,5,5,2,4,6,4,4,"High",0,0
"1404",10,78,1,1.7627,18,101,2,6,0,2,2,0,4,"Low",-4,4
"1405",10,79,1,0.94808,39,24,9,6,2,1,3,2,4,"Low",3,3
"1406",10,80,1,1.1956,138,25,8,8,3,1,4,3,4,"Low",0,0
"1407",10,81,1,1.5443,134,44,7,7,1,2,3,1,4,"Low",0,0
"1408",10,82,1,1.0857,112,143,8,3,1,1,2,1,4,"Low",5,5
"1409",10,83,1,0.9145,111,51,8,7,1,1,2,1,4,"Low",1,1
"1410",10,84,1,3.1965,132,83,8,10,2,2,4,2,4,"Low",-2,2
"1411",10,85,0,1.2264,54,122,6,8,2,4,6,4,4,"High",-2,2
"1412",10,86,1,1.2165,21,18,4,2,2,1,3,2,4,"Low",2,2
"1413",10,87,0,0.99109,79,101,5,6,3,3,6,3,4,"High",-1,1
"1414",10,88,0,1.2613,36,47,4,6,1,4,5,4,4,"High",-2,2
"1415",10,89,0,1.5491,105,39,5,9,4,3,7,3,4,"High",-4,4
"1416",10,90,1,1.5605,38,58,2,5,1,3,4,1,4,"Low",-3,3
"1417",10,91,0,1.0579,93,66,1,5,0,4,4,4,4,"Low",-4,4
"1418",10,92,0,1.1292,97,91,3,6,1,1,2,1,4,"Low",-3,3
"1419",10,93,1,1.1126,51,25,7,8,2,2,4,2,4,"Low",-1,1
"1420",10,94,1,0.96219,20,25,3,8,2,3,5,2,4,"High",-5,5
"1421",10,95,0,1.3542,134,70,7,6,2,1,3,1,4,"Low",1,1
"1422",10,96,1,2.2269,51,82,7,8,3,0,3,3,4,"Low",-1,1
"1423",10,97,1,1.1763,41,85,10,7,0,1,1,0,4,"Low",3,3
"1424",10,98,0,0.85567,57,117,8,4,1,0,1,0,4,"Low",4,4
"1425",10,99,0,1.1871,81,14,3,3,0,0,0,0,4,"Low",0,0
"1426",10,100,0,4.9548,76,25,3,8,1,4,5,4,4,"High",-5,5
"1427",10,101,1,5.5156,130,48,4,5,0,4,4,0,4,"Low",-1,1
"1428",10,102,0,1.8779,44,134,7,7,3,3,6,3,4,"High",0,0
"1429",10,103,0,1.1841,8,70,6,6,2,2,4,2,4,"Low",0,0
"1430",10,104,1,1.0582,8,68,6,5,3,1,4,3,4,"Low",1,1
"1431",10,105,0,1.09,52,89,5,7,3,4,7,4,4,"High",-2,2
"1432",10,106,1,1.6468,45,70,8,6,1,3,4,1,4,"Low",2,2
"1433",10,107,1,1.1234,57,67,8,5,2,3,5,2,4,"High",3,3
"1434",10,108,1,1.5728,143,43,3,7,2,2,4,2,4,"Low",-4,4
"1435",10,109,0,1.4498,16,146,7,10,0,3,3,3,4,"Low",-3,3
"1436",10,110,1,1.0629,125,90,7,6,2,4,6,2,4,"High",1,1
"1437",10,111,0,2.8403,117,82,4,8,1,1,2,1,4,"Low",-4,4
"1438",10,112,0,1.0613,49,85,5,7,2,2,4,2,4,"Low",-2,2
"1439",10,113,1,0.94385,50,94,8,3,0,0,0,0,4,"Low",5,5
"1440",10,114,0,1.0105,39,51,9,7,4,4,8,4,4,"High",2,2
"1441",10,115,0,0.91372,129,121,7,9,0,2,2,2,4,"Low",-2,2
"1442",10,116,1,1.364,70,145,6,2,4,2,6,4,4,"High",4,4
"1443",10,117,0,1.2458,57,41,8,10,3,1,4,1,4,"Low",-2,2
"1444",10,118,1,1.0818,74,134,6,7,2,4,6,2,4,"High",-1,1
"1445",10,119,0,0.79322,67,146,5,10,4,4,8,4,4,"High",-5,5
"1446",10,120,1,1.9109,55,81,7,3,2,1,3,2,4,"Low",4,4
"1447",10,121,0,2.184,21,8,4,6,3,4,7,4,4,"High",-2,2
"1448",10,122,1,2.5095,129,68,7,5,1,2,3,1,4,"Low",2,2
"1449",10,123,0,2.1929,43,30,7,8,3,2,5,2,4,"High",-1,1
"1450",10,124,1,1.0196,91,24,6,6,2,2,4,2,4,"Low",0,0
"1451",10,125,1,1.1277,45,118,8,5,2,1,3,2,4,"Low",3,3
"1452",10,126,1,1.0484,55,58,7,5,3,4,7,3,4,"High",2,2
"1453",10,127,0,1.1909,82,55,8,7,2,4,6,4,4,"High",1,1
"1454",10,128,1,1.1503,74,97,6,3,3,2,5,3,4,"High",3,3
"1455",10,129,0,1.3631,85,84,7,10,3,4,7,4,4,"High",-3,3
"1456",10,130,0,0.9617,138,29,8,9,4,1,5,1,4,"High",-1,1
"1457",10,131,0,1.5085,17,143,5,3,0,3,3,3,4,"Low",2,2
"1458",10,132,0,0.89658,76,137,3,3,2,1,3,1,4,"Low",0,0
"1459",10,133,1,2.47,144,46,10,8,0,2,2,0,4,"Low",2,2
"1460",10,134,0,1.1542,82,87,8,10,3,1,4,1,4,"Low",-2,2
"1461",10,135,1,1.0099,68,76,5,3,3,3,6,3,4,"High",2,2
"1462",10,136,0,1.1048,101,121,6,9,4,3,7,3,4,"High",-3,3
"1463",10,137,1,1.6186,124,118,4,5,4,2,6,4,4,"High",-1,1
"1464",10,138,0,0.94004,43,92,7,7,4,1,5,1,4,"High",0,0
"1465",10,139,0,1.4542,73,132,10,8,2,3,5,3,4,"High",2,2
"1466",10,140,1,1.2294,68,129,5,7,4,2,6,4,4,"High",-2,2
"1467",10,141,1,1.3076,41,57,10,8,2,4,6,2,4,"High",2,2
"1468",10,142,1,1.9151,41,73,10,10,3,3,6,3,4,"High",0,0
"1469",10,143,1,1.3329,20,93,3,1,3,1,4,3,4,"Low",2,2
"1470",10,144,1,1.0698,21,104,4,1,4,0,4,4,4,"Low",3,3
"1471",10,145,0,1.4965,133,83,8,10,2,3,5,3,4,"High",-2,2
"1472",10,146,1,1.0037,34,72,10,5,2,1,3,2,4,"Low",5,5
"1473",10,147,0,1.0132,17,94,5,3,1,1,2,1,4,"Low",2,2
"1474",10,148,1,1.8459,129,130,7,4,3,1,4,3,4,"Low",3,3
"1475",10,149,1,1.0154,16,130,7,4,1,2,3,1,4,"Low",3,3
"1476",10,150,0,1.1006,45,83,8,10,3,4,7,4,4,"High",-2,2
"1477",10,151,0,0.97564,143,2,3,8,4,2,6,2,4,"High",-5,5
"1478",10,152,1,0.99098,91,81,6,3,3,2,5,3,4,"High",3,3
"1479",10,153,0,0.86259,81,85,3,7,3,4,7,4,4,"High",-4,4
"1480",10,154,1,1.1231,113,49,7,5,2,3,5,2,4,"High",2,2
"1481",10,155,0,1.2418,49,104,5,1,4,1,5,1,4,"High",4,4
"1482",10,156,0,0.94097,100,91,2,6,2,4,6,4,4,"High",-4,4
"1483",10,157,1,2.2244,14,69,3,3,1,3,4,1,4,"Low",0,0
"1484",10,158,1,0.99784,16,123,7,4,2,2,4,2,4,"Low",3,3
"1485",10,159,0,0.91065,102,125,3,7,0,3,3,3,4,"Low",-4,4
"1486",10,160,0,1.1726,16,35,7,10,3,1,4,1,4,"Low",-3,3
"1487",10,161,0,1.13,139,121,8,9,2,4,6,4,4,"High",-1,1
"1488",10,162,1,1.2107,38,17,2,5,2,2,4,2,4,"Low",-3,3
"1489",10,163,1,2.2392,94,24,3,6,2,3,5,2,4,"High",-3,3
"1490",10,164,0,1.2315,29,74,9,6,2,4,6,4,4,"High",3,3
"1491",10,165,1,1.2473,38,52,2,5,3,4,7,3,4,"High",-3,3
"1492",10,166,1,0.79869,34,29,10,9,3,3,6,3,4,"High",1,1
"1493",10,167,1,1.4163,20,99,3,2,4,2,6,4,4,"High",1,1
"1494",10,168,0,0.98644,76,125,3,7,4,4,8,4,4,"High",-4,4
"1495",10,169,0,1.5942,69,38,3,2,4,4,8,4,4,"High",1,1
"1496",10,170,0,1.2409,72,94,5,3,2,3,5,3,4,"High",2,2
"1497",10,171,0,1.0939,44,54,7,6,4,3,7,3,4,"High",1,1
"1498",10,172,0,2.4495,93,123,1,4,2,3,5,3,4,"High",-3,3
"1499",10,173,1,1.099,113,129,7,7,3,4,7,3,4,"High",0,0
"1500",10,174,1,1.9098,140,2,9,8,1,3,4,1,4,"Low",1,1
"1501",10,175,1,5.2793,87,41,10,10,2,4,6,2,4,"High",0,0
"1502",10,176,0,3.2668,145,40,2,1,3,2,5,2,4,"High",1,1
"1503",10,177,0,1.1381,145,54,2,6,4,4,8,4,4,"High",-4,4
"1504",10,178,0,1.4954,40,97,1,3,3,3,6,3,4,"High",-2,2
"1505",10,179,1,1.0807,14,18,3,2,2,2,4,2,4,"Low",1,1
"1506",10,180,1,1.2334,93,72,1,5,3,3,6,3,4,"High",-4,4
"1507",10,181,0,1.0468,50,87,8,10,1,3,4,3,4,"Low",-2,2
"1508",10,182,0,1.0897,102,130,3,4,1,3,4,3,4,"Low",-1,1
"1509",10,183,0,1.1876,79,16,5,7,4,4,8,4,4,"High",-2,2
"1510",10,184,1,1.0077,112,65,8,7,2,0,2,2,4,"Low",1,1
"1511",10,185,0,1.4425,78,81,4,3,1,4,5,4,4,"High",1,1
"1512",10,186,0,0.9431,80,140,4,9,3,2,5,2,4,"High",-5,5
"1513",10,187,0,1.0959,40,137,1,3,4,2,6,2,4,"High",-2,2
"1514",10,188,0,0.96595,94,82,3,8,4,4,8,4,4,"High",-5,5
"1515",10,189,1,1.0613,2,97,8,3,4,4,8,4,4,"High",5,5
"1516",10,190,0,1.0781,17,137,5,3,3,3,6,3,4,"High",2,2
"1517",10,191,1,1.2253,99,78,2,4,3,2,5,3,4,"High",-2,2
"1518",10,192,0,0.95986,118,139,5,8,3,3,6,3,4,"High",-3,3
"1519",10,193,0,1.5994,120,36,1,4,0,2,2,2,4,"Low",-3,3
"1520",10,194,0,1.0106,29,35,9,10,4,2,6,2,4,"High",-1,1
"1521",10,195,0,1.3815,36,132,4,8,3,4,7,4,4,"High",-4,4
"1522",10,196,0,0.87691,65,87,7,10,1,4,5,4,4,"High",-3,3
"1523",10,197,0,0.98405,102,130,3,4,2,4,6,4,4,"High",-1,1
"1524",10,198,0,2.2767,133,144,8,10,3,1,4,1,4,"Low",-2,2
"1525",10,199,0,0.86837,123,140,4,9,4,3,7,3,4,"High",-5,5
"1526",10,200,0,0.78365,65,92,7,7,2,2,4,2,4,"Low",0,0
"1527",11,1,1,1.1019,1,33,6,3,0,0,0,0,4,"Low",3,3
"1528",11,2,0,1.3507,88,34,3,6,0,0,0,0,4,"Low",-3,3
"1529",11,3,0,0.61429,91,87,7,6,0,0,0,0,4,"Low",1,1
"1530",11,4,0,0.58784,106,113,5,5,0,0,0,0,4,"Low",0,0
"1531",11,5,0,0.51239,104,85,7,9,0,0,0,0,4,"Low",-2,2
"1532",11,6,1,0.64471,113,91,5,7,1,1,2,1,4,"Low",-2,2
"1533",11,7,1,0.60998,65,74,10,9,0,0,0,0,4,"Low",1,1
"1534",11,8,1,0.79157,9,63,6,2,0,0,0,0,4,"Low",4,4
"1535",11,9,0,0.68459,111,102,5,6,0,0,0,0,4,"Low",-1,1
"1536",11,10,0,0.78589,102,31,6,7,1,0,1,0,4,"Low",-1,1
"1537",11,11,1,0.53894,139,25,10,10,0,0,0,0,4,"Low",0,0
"1538",11,12,1,0.7323,16,98,8,8,0,0,0,0,4,"Low",0,0
"1539",11,13,1,0.69331,99,18,9,8,0,0,0,0,4,"Low",1,1
"1540",11,14,1,1.0083,14,144,7,8,0,0,0,0,4,"Low",-1,1
"1541",11,15,1,0.79016,66,7,10,5,0,0,0,0,4,"Low",5,5
"1542",11,16,1,1.1155,58,68,9,8,0,0,0,0,4,"Low",1,1
"1543",11,17,0,0.85315,16,96,8,9,1,0,1,0,4,"Low",-1,1
"1544",11,18,0,0.85781,100,66,6,10,0,1,1,1,4,"Low",-4,4
"1545",11,19,0,0.78981,40,2,1,6,0,0,0,0,4,"Low",-5,5
"1546",11,20,1,0.9113,94,145,6,3,0,0,0,0,4,"Low",3,3
"1547",11,21,1,0.81376,122,18,5,8,0,1,1,0,4,"Low",-3,3
"1548",11,22,1,0.61911,14,112,7,8,1,0,1,1,4,"Low",-1,1
"1549",11,23,0,0.95264,72,90,10,6,0,0,0,0,4,"Low",4,4
"1550",11,24,0,0.72986,133,87,10,6,0,1,1,1,4,"Low",4,4
"1551",11,25,1,0.61069,31,92,7,5,1,0,1,1,4,"Low",2,2
"1552",11,26,0,0.68982,124,87,10,6,0,2,2,2,4,"Low",4,4
"1553",11,27,1,0.63738,66,119,10,6,2,0,2,2,4,"Low",4,4
"1554",11,28,1,0.80941,16,93,8,7,2,0,2,2,4,"Low",1,1
"1555",11,29,0,1.5195,26,8,4,1,0,0,0,0,4,"Low",3,3
"1556",11,30,0,1.3695,18,94,8,6,2,1,3,1,4,"Low",2,2
"1557",11,31,1,1.2722,94,51,6,8,2,0,2,2,4,"Low",-2,2
"1558",11,32,0,0.98823,51,85,8,9,1,1,2,1,4,"Low",-1,1
"1559",11,33,0,0.90562,126,103,7,6,0,0,0,0,4,"Low",1,1
"1560",11,34,0,0.95345,121,140,7,7,0,0,0,0,4,"Low",0,0
"1561",11,35,1,0.663,66,92,10,5,3,1,4,3,4,"Low",5,5
"1562",11,36,0,1.2556,112,51,8,8,1,2,3,2,4,"Low",0,0
"1563",11,37,0,0.94773,36,73,7,9,0,0,0,0,4,"Low",-2,2
"1564",11,38,1,0.63357,66,73,10,9,4,1,5,4,4,"High",1,1
"1565",11,39,1,0.69235,65,51,10,8,1,3,4,1,4,"Low",2,2
"1566",11,40,1,1.5544,123,119,5,6,0,1,1,0,4,"Low",-1,1
"1567",11,41,0,1.0819,114,111,5,5,0,1,1,1,4,"Low",0,0
"1568",11,42,1,0.92172,96,91,9,7,1,2,3,1,4,"Low",2,2
"1569",11,43,0,0.81461,112,25,8,10,2,1,3,1,4,"Low",-2,2
"1570",11,44,1,0.93106,9,50,6,10,1,0,1,1,4,"Low",-4,4
"1571",11,45,0,0.91443,26,15,4,9,1,0,1,0,4,"Low",-5,5
"1572",11,46,1,0.77382,101,51,10,8,0,4,4,0,4,"Low",2,2
"1573",11,47,1,0.8821,57,33,8,3,0,1,1,0,4,"Low",5,5
"1574",11,48,1,1.0606,104,105,7,7,1,0,1,1,4,"Low",0,0
"1575",11,49,0,0.84543,72,96,10,9,1,2,3,2,4,"Low",1,1
"1576",11,50,0,1.2013,98,85,8,9,1,2,3,2,4,"Low",-1,1
"1577",11,51,1,0.55528,16,110,8,4,3,0,3,3,4,"Low",4,4
"1578",11,52,0,0.59548,33,41,3,7,2,0,2,0,4,"Low",-4,4
"1579",11,53,1,0.62432,123,2,5,6,1,1,2,1,4,"Low",-1,1
"1580",11,54,1,0.88435,119,40,6,1,2,1,3,2,4,"Low",5,5
"1581",11,55,1,1.2928,144,132,8,9,1,0,1,1,4,"Low",-1,1
"1582",11,56,1,0.95506,85,31,9,7,3,2,5,3,4,"High",2,2
"1583",11,57,0,0.76228,20,97,5,8,0,0,0,0,4,"Low",-3,3
"1584",11,58,0,0.90259,119,49,6,8,3,0,3,0,4,"Low",-2,2
"1585",11,59,1,1.5072,2,20,6,5,2,1,3,2,4,"Low",1,1
"1586",11,60,0,1.1252,31,2,7,6,3,3,6,3,4,"High",1,1
"1587",11,61,1,1.0943,49,121,8,7,1,1,2,1,4,"Low",1,1
"1588",11,62,1,1.1859,35,100,5,6,0,1,1,0,4,"Low",-1,1
"1589",11,63,0,1.561,106,33,5,3,1,3,4,3,4,"Low",2,2
"1590",11,64,0,0.72943,96,87,9,6,3,3,6,3,4,"High",3,3
"1591",11,65,0,0.86741,25,122,10,5,2,1,3,1,4,"Low",5,5
"1592",11,66,1,1.0781,31,112,7,8,4,3,7,4,4,"High",-1,1
"1593",11,67,0,0.94413,86,124,7,10,0,1,1,1,4,"Low",-3,3
"1594",11,68,1,1.0186,129,104,9,7,0,2,2,0,4,"Low",2,2
"1595",11,69,0,0.62827,105,65,7,10,1,2,3,2,4,"Low",-3,3
"1596",11,70,1,0.64222,129,34,9,6,1,1,2,1,4,"Low",3,3
"1597",11,71,1,0.68684,25,74,10,9,3,1,4,3,4,"Low",1,1
"1598",11,72,0,0.79354,20,36,5,7,2,1,3,1,4,"Low",-2,2
"1599",11,73,1,0.92616,86,145,7,3,1,1,2,1,4,"Low",4,4
"1600",11,74,1,0.68633,89,67,8,3,0,0,0,0,4,"Low",5,5
"1601",11,75,0,1.369,34,1,6,6,2,1,3,1,4,"Low",0,0
"1602",11,76,0,1.2083,73,1,9,6,2,2,4,2,4,"Low",3,3
"1603",11,77,1,3.0063,102,145,6,3,2,2,4,2,4,"Low",3,3
"1604",11,78,0,0.71859,36,1,7,6,2,3,5,3,4,"High",1,1
"1605",11,79,0,0.86977,73,41,9,7,3,1,4,1,4,"Low",2,2
"1606",11,80,0,1.5459,53,94,3,6,0,3,3,3,4,"Low",-3,3
"1607",11,81,1,1.2019,112,145,8,3,4,3,7,4,4,"High",5,5
"1608",11,82,1,1.336,41,53,7,3,2,1,3,2,4,"Low",4,4
"1609",11,83,1,0.79739,34,119,6,6,3,4,7,3,4,"High",0,0
"1610",11,84,1,0.67196,133,98,10,8,1,2,3,1,4,"Low",2,2
"1611",11,85,0,0.83749,68,36,8,7,1,3,4,3,4,"Low",1,1
"1612",11,86,0,0.6367,36,129,7,9,4,2,6,2,4,"High",-2,2
"1613",11,87,0,1.0148,55,89,9,8,0,1,1,1,4,"Low",1,1
"1614",11,88,0,0.73948,30,125,2,6,0,0,0,0,4,"Low",-4,4
"1615",11,89,0,0.91762,100,7,6,5,2,1,3,1,4,"Low",1,1
"1616",11,90,0,0.88811,34,132,6,9,4,1,5,1,4,"High",-3,3
"1617",11,91,1,0.84382,85,72,9,10,4,2,6,4,4,"High",-1,1
"1618",11,92,0,0.81752,29,93,2,7,0,1,1,1,4,"Low",-5,5
"1619",11,93,1,0.79148,133,104,10,7,2,3,5,2,4,"High",3,3
"1620",11,94,1,1.1964,20,68,5,8,3,2,5,3,4,"High",-3,3
"1621",11,95,1,1.3039,144,68,8,8,2,3,5,2,4,"High",0,0
"1622",11,96,0,0.88114,129,35,9,5,3,1,4,1,4,"Low",4,4
"1623",11,97,0,0.77257,92,104,5,7,2,4,6,4,4,"High",-2,2
"1624",11,98,0,0.5405,53,89,3,8,2,2,4,2,4,"Low",-5,5
"1625",11,99,1,0.685,65,93,10,7,3,2,5,3,4,"High",3,3
"1626",11,100,1,0.85592,57,110,8,4,1,1,2,1,4,"Low",4,4
"1627",11,101,0,1.0885,29,67,2,3,1,1,2,1,4,"Low",-1,1
"1628",11,102,1,0.7085,111,114,5,5,2,1,3,2,4,"Low",0,0
"1629",11,103,0,0.6913,145,29,3,2,4,2,6,2,4,"High",1,1
"1630",11,104,0,1.4074,20,9,5,6,4,2,6,2,4,"High",-1,1
"1631",11,105,0,1.2021,90,52,6,8,1,0,1,0,4,"Low",-2,2
"1632",11,106,1,0.98599,72,103,10,6,3,1,4,3,4,"Low",4,4
"1633",11,107,0,0.60492,110,98,4,8,2,3,5,3,4,"High",-4,4
"1634",11,108,0,0.55939,72,65,10,10,4,4,8,4,4,"High",0,0
"1635",11,109,0,0.615,1,58,6,9,4,1,5,1,4,"High",-3,3
"1636",11,110,1,0.80494,111,105,5,7,3,2,5,3,4,"High",-2,2
"1637",11,111,1,0.90704,122,18,5,8,2,3,5,2,4,"High",-3,3
"1638",11,112,0,0.68352,110,41,4,7,3,3,6,3,4,"High",-3,3
"1639",11,113,0,0.64686,122,14,5,7,3,2,5,2,4,"High",-2,2
"1640",11,114,1,0.73216,87,90,6,6,4,2,6,4,4,"High",0,0
"1641",11,115,0,0.62868,122,41,5,7,4,4,8,4,4,"High",-2,2
"1642",11,116,0,1.2096,133,58,10,9,3,2,5,2,4,"High",1,1
"1643",11,117,1,0.73431,30,126,2,7,1,1,2,1,4,"Low",-5,5
"1644",11,118,0,0.87175,38,7,1,5,0,2,2,2,4,"Low",-4,4
"1645",11,119,1,1.1472,63,8,2,1,1,1,2,1,4,"Low",1,1
"1646",11,120,1,1.6653,26,33,4,3,2,4,6,2,4,"High",1,1
"1647",11,121,1,0.7059,129,80,9,5,4,0,4,4,4,"Low",4,4
"1648",11,122,0,0.81114,100,67,6,3,3,2,5,2,4,"High",3,3
"1649",11,123,0,0.54549,9,89,6,8,3,3,6,3,4,"High",-2,2
"1650",11,124,0,0.60991,30,7,2,5,2,3,5,3,4,"High",-3,3
"1651",11,125,0,0.7215,14,97,7,8,3,1,4,1,4,"Low",-1,1
"1652",11,126,0,1.3543,114,73,5,9,2,4,6,4,4,"High",-4,4
"1653",11,127,1,1.0022,50,114,10,5,1,3,4,1,4,"Low",5,5
"1654",11,128,0,0.781,123,14,5,7,2,4,6,4,4,"High",-2,2
"1655",11,129,0,0.60904,106,144,5,8,2,3,5,3,4,"High",-3,3
"1656",11,130,1,0.90365,57,113,8,5,2,2,4,2,4,"Low",3,3
"1657",11,131,0,0.69548,97,74,8,9,2,2,4,2,4,"Low",-1,1
"1658",11,132,0,0.67846,29,100,2,6,3,4,7,4,4,"High",-4,4
"1659",11,133,1,0.57365,50,105,10,7,2,3,5,2,4,"High",3,3
"1660",11,134,0,0.79559,7,99,5,9,4,1,5,1,4,"High",-4,4
"1661",11,135,0,0.99121,110,58,4,9,4,3,7,3,4,"High",-5,5
"1662",11,136,1,0.78062,88,26,3,4,1,3,4,1,4,"Low",-1,1
"1663",11,137,1,0.85129,132,98,9,8,2,4,6,2,4,"High",1,1
"1664",11,138,0,1.1748,50,132,10,9,3,3,6,3,4,"High",1,1
"1665",11,139,1,0.73592,50,94,10,6,4,4,8,4,4,"High",4,4
"1666",11,140,1,0.86723,25,121,10,7,4,2,6,4,4,"High",3,3
"1667",11,141,1,0.87067,2,55,6,9,4,1,5,4,4,"High",-3,3
"1668",11,142,1,1.1787,35,30,5,2,2,3,5,2,4,"High",3,3
"1669",11,143,1,1.0468,93,52,7,8,3,1,4,3,4,"Low",-1,1
"1670",11,144,0,0.72156,16,58,8,9,4,4,8,4,4,"High",-1,1
"1671",11,145,1,1.2913,105,68,7,8,4,4,8,4,4,"High",-1,1
"1672",11,146,0,1.0602,113,30,5,2,3,4,7,4,4,"High",3,3
"1673",11,147,1,1.1843,123,38,5,1,3,1,4,3,4,"Low",4,4
"1674",11,148,0,1.3023,113,118,5,6,4,0,4,0,4,"Low",-1,1
"1675",11,149,0,0.92017,91,89,7,8,3,4,7,4,4,"High",-1,1
"1676",11,150,0,0.76363,92,144,5,8,3,4,7,4,4,"High",-3,3
"1677",11,151,0,1.0563,35,124,5,10,3,2,5,2,4,"High",-5,5
"1678",11,152,0,0.59646,26,140,4,7,4,1,5,1,4,"High",-3,3
"1679",11,153,0,0.56357,67,90,3,6,3,3,6,3,4,"High",-3,3
"1680",11,154,0,0.4679,18,90,8,6,4,4,8,4,4,"High",2,2
"1681",11,155,1,0.66234,74,92,9,5,3,4,7,3,4,"High",4,4
"1682",11,156,0,0.55268,96,99,9,9,4,2,6,2,4,"High",0,0
"1683",11,157,1,0.72899,99,106,9,5,3,3,6,3,4,"High",4,4
"1684",11,158,1,0.73864,133,111,10,5,4,4,8,4,4,"High",5,5
"1685",11,159,0,1.0678,91,140,7,7,4,2,6,2,4,"High",0,0
"1686",11,160,0,1.0133,86,15,7,9,2,1,3,1,4,"Low",-2,2
"1687",11,161,1,0.97474,125,103,6,6,1,2,3,1,4,"Low",0,0
"1688",11,162,0,0.62288,80,52,5,8,1,2,3,2,4,"Low",-3,3
"1689",11,163,0,0.83017,118,49,6,8,1,2,3,2,4,"Low",-2,2
"1690",11,164,0,0.89958,103,86,6,7,3,3,6,3,4,"High",-1,1
"1691",11,165,1,0.7762,132,93,9,7,4,4,8,4,4,"High",2,2
"1692",11,166,1,0.86422,101,57,10,8,1,3,4,1,4,"Low",2,2
"1693",11,167,0,0.65818,121,118,7,6,3,2,5,2,4,"High",1,1
"1694",11,168,1,0.6855,140,29,7,2,3,4,7,3,4,"High",5,5
"1695",11,169,0,1.0811,103,63,6,2,4,2,6,2,4,"High",4,4
"1696",11,170,1,1.1706,52,53,8,3,3,3,6,3,4,"High",5,5
"1697",11,171,1,1.1618,15,106,9,5,2,4,6,2,4,"High",4,4
"1698",11,172,0,1.3266,55,99,9,9,2,4,6,4,4,"High",0,0
"1699",11,173,1,1.6953,139,124,10,10,1,3,4,1,4,"Low",0,0
"1700",11,174,0,2.7385,9,63,6,2,4,3,7,3,4,"High",4,4
"1701",11,175,1,1.4672,139,124,10,10,2,4,6,2,4,"High",0,0
"1702",11,176,0,0.9506,121,63,7,2,4,4,8,4,4,"High",5,5
"1703",11,177,1,1.11,49,53,8,3,3,4,7,3,4,"High",5,5
"1704",11,178,1,1.6631,55,86,9,7,3,4,7,3,4,"High",2,2
"1705",11,179,0,1.2187,15,57,9,8,3,4,7,4,4,"High",1,1
"1706",11,180,0,1.32,80,67,5,3,2,4,6,4,4,"High",2,2
"1707",11,181,0,1.7528,40,102,1,6,2,3,5,3,4,"High",-5,5
"1708",11,182,1,0.82291,97,102,8,6,3,4,7,3,4,"High",2,2
"1709",11,183,0,1.3215,80,88,5,3,3,2,5,2,4,"High",2,2
"1710",11,184,0,0.8324,114,123,5,5,4,4,8,4,4,"High",0,0
"1711",11,185,0,1.3542,15,35,9,5,4,4,8,4,4,"High",4,4
"1712",11,186,1,1.1303,140,74,7,9,4,4,8,4,4,"High",-2,2
"1713",11,187,0,1.3937,118,52,6,8,3,4,7,4,4,"High",-2,2
"1714",11,188,0,1.2678,38,8,1,1,2,2,4,2,4,"Low",0,0
"1715",11,189,0,1.1502,8,125,1,6,3,2,5,2,4,"High",-5,5
"1716",11,190,0,0.70988,40,38,1,1,3,3,6,3,4,"High",0,0
"1717",11,191,1,0.95845,55,49,9,8,4,4,8,4,4,"High",1,1
"1718",11,192,0,1.117,101,139,10,10,2,3,5,3,4,"High",0,0
"1719",11,193,0,0.78997,126,101,7,10,2,3,5,3,4,"High",-3,3
"1720",11,194,1,1.3293,118,125,6,6,4,3,7,4,4,"High",0,0
"1721",11,195,1,1.1087,88,38,3,1,3,4,7,3,4,"High",2,2
"1722",11,196,1,1.5653,8,125,1,6,4,4,8,4,4,"High",-5,5
"1723",11,197,1,0.79994,97,126,8,7,4,3,7,4,4,"High",1,1
"1724",11,198,1,0.7652,101,126,10,7,4,4,8,4,4,"High",3,3
"1725",11,199,0,0.76009,78,80,1,5,0,4,4,4,4,"Low",-4,4
"1726",11,200,0,0.76937,40,88,1,3,4,4,8,4,4,"High",-2,2
"1727",12,1,0,0.79143,29,88,2,6,0,0,0,0,4,"Low",-4,4
"1728",12,2,0,0.76653,103,27,1,5,0,0,0,0,4,"Low",-4,4
"1729",12,3,0,0.67988,84,27,1,5,0,1,1,1,4,"Low",-4,4
"1730",12,4,0,2.7578,84,83,1,1,1,0,1,0,4,"Low",0,0
"1731",12,5,1,1.1947,146,54,4,1,0,0,0,0,4,"Low",3,3
"1732",12,6,0,2.1373,83,29,1,2,1,1,2,1,4,"Low",-1,1
"1733",12,7,0,1.0919,88,87,6,9,1,0,1,0,4,"Low",-3,3
"1734",12,8,0,0.82533,29,54,2,1,2,1,3,1,4,"Low",1,1
"1735",12,9,0,1.9175,100,105,1,4,0,0,0,0,4,"Low",-3,3
"1736",12,10,0,1.1914,55,117,10,10,0,0,0,0,4,"Low",0,0
"1737",12,11,0,0.85102,52,138,1,1,0,0,0,0,4,"Low",0,0
"1738",12,12,1,2.1076,54,52,1,1,2,1,3,2,4,"Low",0,0
"1739",12,13,1,0.94527,27,102,5,1,2,0,2,2,4,"Low",4,4
"1740",12,14,1,5.5757,16,103,2,1,0,1,1,0,4,"Low",1,1
"1741",12,15,0,1.1238,130,45,4,7,0,0,0,0,4,"Low",-3,3
"1742",12,16,0,1.7737,41,116,10,5,0,0,0,0,4,"Low",5,5
"1743",12,17,1,4.5444,103,102,1,1,2,1,3,2,4,"Low",0,0
"1744",12,18,0,1.2728,55,66,10,7,1,0,1,0,4,"Low",3,3
"1745",12,19,1,1.152,116,100,5,1,1,1,2,1,4,"Low",4,4
"1746",12,20,0,7.1498,123,102,2,1,0,2,2,2,4,"Low",1,1
"1747",12,21,1,1.0673,29,3,2,3,3,0,3,3,4,"Low",-1,1
"1748",12,22,1,0.70945,118,45,8,7,0,1,1,0,4,"Low",1,1
"1749",12,23,0,1.0623,83,33,1,2,2,0,2,0,4,"Low",-1,1
"1750",12,24,1,0.71178,119,146,9,4,0,1,1,0,4,"Low",5,5
"1751",12,25,1,1.0603,104,125,6,1,0,0,0,0,4,"Low",5,5
"1752",12,26,0,0.96247,123,134,2,4,1,0,1,0,4,"Low",-2,2
"1753",12,27,1,2.8309,130,138,4,1,1,1,2,1,4,"Low",3,3
"1754",12,28,0,0.95234,84,116,1,5,2,2,4,2,4,"Low",-4,4
"1755",12,29,1,0.82838,122,65,8,8,0,0,0,0,4,"Low",0,0
"1756",12,30,0,0.85526,34,88,7,6,0,2,2,2,4,"Low",1,1
"1757",12,31,1,0.6199,146,92,4,1,2,0,2,2,4,"Low",3,3
"1758",12,32,0,3.1004,105,33,4,2,1,1,2,1,4,"Low",2,2
"1759",12,33,0,0.63529,92,116,1,5,1,3,4,3,4,"Low",-4,4
"1760",12,34,0,0.8025,92,33,1,2,2,2,4,2,4,"Low",-1,1
"1761",12,35,1,1.062,84,52,1,1,3,2,5,3,4,"High",0,0
"1762",12,36,0,0.72801,34,3,7,3,1,1,2,1,4,"Low",4,4
"1763",12,37,0,2.1962,113,117,9,10,0,1,1,1,4,"Low",-1,1
"1764",12,38,1,1.0042,66,123,7,2,1,2,3,1,4,"Low",5,5
"1765",12,39,0,0.82022,54,116,1,5,3,4,7,4,4,"High",-4,4
"1766",12,40,0,2.1735,88,113,6,9,3,1,4,1,4,"Low",-3,3
"1767",12,41,0,1.6336,103,62,1,1,3,0,3,0,4,"Low",0,0
"1768",12,42,0,1.5455,32,104,1,6,0,1,1,1,4,"Low",-5,5
"1769",12,43,0,0.68521,103,27,1,5,4,3,7,3,4,"High",-4,4
"1770",12,44,0,1.2965,16,27,2,5,1,4,5,4,4,"High",-3,3
"1771",12,45,0,1.1065,29,46,2,6,4,0,4,0,4,"Low",-4,4
"1772",12,46,1,2.2327,46,138,6,1,1,2,3,1,4,"Low",5,5
"1773",12,47,0,2.1593,62,21,1,3,1,0,1,0,4,"Low",-2,2
"1774",12,48,1,1.5885,130,92,4,1,2,3,5,2,4,"High",3,3
"1775",12,49,1,2.6094,143,123,1,2,0,3,3,0,4,"Low",-1,1
"1776",12,50,1,1.8553,88,125,6,1,4,1,5,4,4,"High",5,5
"1777",12,51,1,1.1254,33,112,2,2,3,0,3,3,4,"Low",0,0
"1778",12,52,1,4.8148,45,105,7,4,2,2,4,2,4,"Low",3,3
"1779",12,53,1,2.1327,146,46,4,6,3,2,5,3,4,"High",-2,2
"1780",12,54,1,3.877,113,134,9,4,2,1,3,2,4,"Low",5,5
"1781",12,55,0,1.5171,125,32,1,1,2,1,3,1,4,"Low",0,0
"1782",12,56,1,0.97465,85,45,10,7,0,3,3,0,4,"Low",3,3
"1783",12,57,1,5.6211,117,55,10,10,2,2,4,2,4,"Low",0,0
"1784",12,58,1,0.90588,18,45,8,7,0,4,4,0,4,"Low",1,1
"1785",12,59,0,1.4365,65,85,8,10,1,1,2,1,4,"Low",-2,2
"1786",12,60,1,1.1874,30,125,3,1,0,3,3,0,4,"Low",2,2
"1787",12,61,1,1.0073,134,138,4,1,2,3,5,2,4,"High",3,3
"1788",12,62,0,1.0147,123,146,2,4,4,4,8,4,4,"High",-2,2
"1789",12,63,1,1.0782,46,143,6,1,3,1,4,3,4,"Low",5,5
"1790",12,64,1,0.93623,41,113,10,9,1,3,4,1,4,"Low",1,1
"1791",12,65,0,0.72637,92,134,1,4,4,3,7,3,4,"High",-3,3
"1792",12,66,1,0.74971,104,138,6,1,2,4,6,2,4,"High",5,5
"1793",12,67,0,1.0376,46,85,6,10,4,2,6,2,4,"High",-4,4
"1794",12,68,0,1.0823,3,130,3,4,2,3,5,3,4,"High",-1,1
"1795",12,69,0,1.0704,18,41,8,10,1,2,3,2,4,"Low",-2,2
"1796",12,70,0,0.65582,3,105,3,4,3,3,6,3,4,"High",-1,1
"1797",12,71,1,0.67576,117,85,10,10,3,3,6,3,4,"High",0,0
"1798",12,72,0,0.76385,125,83,1,1,4,3,7,3,4,"High",0,0
"1799",12,73,0,0.59515,66,87,7,9,2,1,3,1,4,"Low",-2,2
"1800",12,74,1,0.80113,112,54,2,1,1,4,5,1,4,"High",1,1
"1801",12,75,0,0.71126,3,112,3,2,4,2,6,2,4,"High",1,1
"1802",12,76,1,0.82466,83,104,1,6,4,3,7,4,4,"High",-5,5
"1803",12,77,1,1.1213,134,105,4,4,4,4,8,4,4,"High",0,0
"1804",12,78,0,0.91815,102,33,1,2,3,4,7,4,4,"High",-1,1
"1805",12,79,0,1.3581,87,117,9,10,2,4,6,4,4,"High",-1,1
"1806",12,80,0,1.0689,87,113,9,9,3,4,7,4,4,"High",0,0
"1807",12,81,0,1.1655,102,21,1,3,4,1,5,1,4,"High",-2,2
"1808",12,82,0,1.7063,55,18,10,8,3,2,5,2,4,"High",2,2
"1809",12,83,0,1.202,55,65,10,8,4,2,6,2,4,"High",2,2
"1810",12,84,0,0.84302,66,85,7,10,3,4,7,4,4,"High",-3,3
"1811",12,85,0,0.83033,34,65,7,8,2,3,5,3,4,"High",-1,1
"1812",12,86,1,1.4155,84,16,1,2,4,2,6,4,4,"High",-1,1
"1813",12,87,1,1.0578,21,34,3,7,2,3,5,2,4,"High",-4,4
"1814",12,88,1,1.0218,41,87,10,9,3,4,7,3,4,"High",1,1
"1815",12,89,0,0.72228,52,112,1,2,3,3,6,3,4,"High",-1,1
"1816",12,90,1,0.80524,118,130,8,4,1,4,5,1,4,"High",4,4
"1817",12,91,0,1.331,21,122,3,8,3,1,4,1,4,"Low",-5,5
"1818",12,92,0,1.0599,65,63,8,8,4,0,4,0,4,"Low",0,0
"1819",12,93,0,3.0093,118,119,8,9,2,1,3,1,4,"Low",-1,1
"1820",12,94,0,0.83674,52,112,1,2,4,4,8,4,4,"High",-1,1
"1821",12,95,0,0.68274,21,63,3,8,4,1,5,1,4,"High",-5,5
"1822",12,96,1,0.66147,122,34,8,7,2,4,6,2,4,"High",1,1
"1823",12,97,0,4.8861,18,122,8,8,3,3,6,3,4,"High",0,0
"1824",12,98,0,0.73509,30,100,3,1,1,2,3,2,4,"Low",2,2
"1825",12,99,1,0.97404,100,62,1,1,3,2,5,3,4,"High",0,0
"1826",12,100,1,0.62372,41,118,10,8,4,3,7,4,4,"High",2,2
"1827",12,101,0,1.6624,122,119,8,9,4,2,6,2,4,"High",-1,1
"1828",12,102,0,2.209,118,18,8,8,4,4,8,4,4,"High",0,0
"1829",12,103,1,1.077,62,30,1,3,3,2,5,3,4,"High",-2,2
"1830",12,104,0,0.72708,16,30,2,3,3,3,6,3,4,"High",-1,1
"1831",12,105,1,1.5759,100,32,1,1,4,2,6,4,4,"High",0,0
"1832",12,106,0,0.81789,16,104,2,6,4,4,8,4,4,"High",-4,4
"1833",12,107,1,0.62575,63,30,8,3,2,4,6,2,4,"High",5,5
"1834",12,108,1,0.63668,63,66,8,7,3,4,7,3,4,"High",1,1
"1835",12,109,0,0.70864,62,32,1,1,4,3,7,3,4,"High",0,0
"1836",12,110,1,0.64594,119,63,9,8,3,4,7,3,4,"High",1,1
"1837",12,111,0,0.92222,143,32,1,1,2,4,6,4,4,"High",0,0
"1838",13,1,0,1.7948,43,127,1,5,0,0,0,0,3,"Low",-4,4
"1839",13,2,1,1.5933,130,40,8,5,0,0,0,0,3,"Low",3,3
"1840",13,3,0,2.0421,145,147,4,6,0,0,0,0,3,"Low",-2,2
"1841",13,4,1,1.7575,10,14,7,5,0,0,0,0,3,"Low",2,2
"1842",13,5,0,3.2262,8,130,7,8,0,1,1,1,3,"Low",-1,1
"1843",13,6,1,2.0234,22,128,10,9,0,0,0,0,3,"Low",1,1
"1844",13,7,1,3.0283,23,140,7,2,0,0,0,0,3,"Low",5,5
"1845",13,8,0,1.5117,2,130,4,8,0,2,2,2,3,"Low",-4,4
"1846",13,9,0,2.0096,132,80,2,6,0,0,0,0,3,"Low",-4,4
"1847",13,10,0,1.7565,131,79,7,7,0,0,0,0,3,"Low",0,0
"1848",13,11,1,4.3205,99,45,4,1,0,0,0,0,3,"Low",3,3
"1849",13,12,1,1.692,93,103,9,6,0,0,0,0,3,"Low",3,3
"1850",13,13,0,2.5985,86,78,6,8,0,0,0,0,3,"Low",-2,2
"1851",13,14,0,1.7826,62,11,5,7,0,0,0,0,3,"Low",-2,2
"1852",13,15,0,2.9825,134,4,6,6,0,0,0,0,3,"Low",0,0
"1853",13,16,0,1.7394,65,129,5,6,0,0,0,0,3,"Low",-1,1
"1854",13,17,0,1.5947,131,93,7,9,1,1,2,1,3,"Low",-2,2
"1855",13,18,1,2.3542,108,140,6,2,0,1,1,0,3,"Low",4,4
"1856",13,19,1,1.8873,23,35,7,4,1,0,1,1,3,"Low",3,3
"1857",13,20,1,1.778,8,55,7,4,1,0,1,1,3,"Low",3,3
"1858",13,21,1,2.1303,120,29,8,4,0,0,0,0,3,"Low",4,4
"1859",13,22,1,1.6803,15,116,10,5,0,0,0,0,3,"Low",5,5
"1860",13,23,0,1.9543,93,77,9,6,2,0,2,0,3,"Low",3,3
"1861",13,24,1,2.3178,42,27,8,4,0,0,0,0,3,"Low",4,4
"1862",13,25,1,2.0317,147,86,6,6,1,1,2,1,3,"Low",0,0
"1863",13,26,0,1.7138,42,11,8,7,1,1,2,1,3,"Low",1,1
"1864",13,27,0,3.5313,53,17,7,8,0,0,0,0,3,"Low",-1,1
"1865",13,28,1,2.6379,145,25,4,3,1,0,1,1,3,"Low",1,1
"1866",13,29,0,2.0545,136,128,5,9,0,1,1,1,3,"Low",-4,4
"1867",13,30,0,1.8945,136,11,5,7,1,2,3,2,3,"Low",-2,2
"1868",13,31,1,4.2252,60,129,9,6,0,1,1,0,3,"Low",3,3
"1869",13,32,1,1.8761,145,43,4,1,2,1,3,2,3,"Low",3,3
"1870",13,33,1,1.6928,118,113,3,3,0,0,0,0,3,"Low",0,0
"1871",13,34,1,1.3561,130,126,8,6,3,0,3,3,3,"Low",2,2
"1872",13,35,1,1.7701,11,62,7,5,3,1,4,3,3,"High",2,2
"1873",13,36,0,1.2736,3,110,6,6,0,0,0,0,3,"Low",0,0
"1874",13,37,0,1.2208,23,15,7,10,2,1,3,1,3,"Low",-3,3
"1875",13,38,1,2.7194,104,25,7,3,0,1,1,0,3,"Low",4,4
"1876",13,39,0,2.1477,90,48,3,6,0,0,0,0,3,"Low",-3,3
"1877",13,40,0,3.7511,58,76,3,4,0,0,0,0,3,"Low",-1,1
"1878",13,41,1,1.7692,12,98,7,5,0,0,0,0,3,"Low",2,2
"1879",13,42,1,4.4486,135,146,6,7,0,0,0,0,3,"Low",-1,1
"1880",13,43,0,1.9366,29,104,4,7,1,1,2,1,3,"Low",-3,3
"1881",13,44,1,1.748,80,35,6,4,1,1,2,1,3,"Low",2,2
"1882",13,45,1,1.6979,39,122,4,5,0,0,0,0,3,"Low",-1,1
"1883",13,46,1,3.0024,136,119,5,2,2,0,2,2,3,"Low",3,3
"1884",13,47,0,1.7308,122,82,5,5,1,0,1,0,3,"Low",0,0
"1885",13,48,0,1.696,63,79,6,7,0,1,1,1,3,"Low",-1,1
"1886",13,49,1,2.5936,82,25,5,3,1,2,3,1,3,"Low",2,2
"1887",13,50,1,1.5741,142,126,9,6,0,1,1,0,3,"Low",3,3
"1888",13,51,0,1.531,53,141,7,7,1,0,1,0,3,"Low",0,0
"1889",13,52,1,3.2816,14,99,5,4,1,1,2,1,3,"Low",1,1
"1890",13,53,0,1.6217,58,131,3,7,1,2,3,2,3,"Low",-4,4
"1891",13,54,0,1.5219,2,4,4,6,1,1,2,1,3,"Low",-2,2
"1892",13,55,0,1.8652,108,48,6,6,1,1,2,1,3,"Low",0,0
"1893",13,56,0,1.1712,136,15,5,10,3,2,5,2,3,"High",-5,5
"1894",13,57,0,1.3599,98,145,5,4,1,3,4,3,3,"High",1,1
"1895",13,58,1,3.0533,61,147,8,6,0,2,2,0,3,"Low",2,2
"1896",13,59,0,5.7985,76,29,4,4,1,2,3,2,3,"Low",0,0
"1897",13,60,0,1.2607,63,91,6,6,1,0,1,0,3,"Low",0,0
"1898",13,61,1,1.6694,127,63,5,6,1,2,3,1,3,"Low",-1,1
"1899",13,62,0,2.0788,108,12,6,7,2,1,3,1,3,"Low",-1,1
"1900",13,63,0,1.6209,97,122,3,5,0,2,2,2,3,"Low",-2,2
"1901",13,64,1,2.1729,78,14,8,5,1,2,3,1,3,"Low",3,3
"1902",13,65,0,1.8808,110,23,6,7,1,3,4,3,3,"High",-1,1
"1903",13,66,0,3.1204,40,33,5,7,1,0,1,0,3,"Low",-2,2
"1904",13,67,0,1.9056,127,147,5,6,2,3,5,3,3,"High",-1,1
"1905",13,68,0,5.6597,143,27,3,4,0,1,1,1,3,"Low",-1,1
"1906",13,69,0,1.4519,105,79,4,7,0,2,2,2,3,"Low",-3,3
"1907",13,70,1,1.6011,4,116,6,5,2,1,3,2,3,"Low",1,1
"1908",13,71,1,1.8526,145,49,4,5,4,0,4,4,3,"High",-1,1
"1909",13,72,0,2.1592,58,28,3,3,2,0,2,0,3,"Low",0,0
"1910",13,73,0,1.6342,37,128,5,9,0,2,2,2,3,"Low",-4,4
"1911",13,74,0,1.5795,86,106,6,10,2,0,2,0,3,"Low",-4,4
"1912",13,75,0,1.7601,35,134,4,6,2,1,3,1,3,"Low",-2,2
"1913",13,76,0,1.2563,25,131,3,7,3,3,6,3,3,"High",-4,4
"1914",13,77,1,1.2472,31,49,2,5,0,1,1,0,3,"Low",-3,3
"1915",13,78,1,1.3832,134,116,6,5,2,2,4,2,3,"High",1,1
"1916",13,79,0,1.4345,114,47,4,8,0,0,0,0,3,"Low",-4,4
"1917",13,80,1,1.3413,95,105,8,4,0,1,1,0,3,"Low",4,4
"1918",13,81,0,1.326,131,52,7,7,4,0,4,0,3,"High",0,0
"1919",13,82,0,2.6345,134,100,6,7,3,0,3,0,3,"Low",-1,1
"1920",13,83,0,1.4701,97,103,3,6,1,1,2,1,3,"Low",-3,3
"1921",13,84,1,2.624,124,134,6,6,0,4,4,0,3,"High",0,0
"1922",13,85,0,2.3155,2,39,4,4,2,1,3,1,3,"Low",0,0
"1923",13,86,1,1.7399,129,118,6,3,2,1,3,2,3,"Low",3,3
"1924",13,87,0,1.3321,49,47,5,8,2,1,3,1,3,"Low",-3,3
"1925",13,88,1,3.66,118,80,3,6,2,2,4,2,3,"High",-3,3
"1926",13,89,1,1.8362,100,41,7,3,1,0,1,1,3,"Low",4,4
"1927",13,90,0,2.1218,104,135,7,6,2,1,3,1,3,"Low",1,1
"1928",13,91,1,1.5618,11,80,7,6,4,3,7,4,3,"High",1,1
"1929",13,92,0,0.95719,56,15,8,10,0,3,3,3,3,"Low",-2,2
"1930",13,93,0,0.93436,8,22,7,10,2,1,3,1,3,"Low",-3,3
"1931",13,94,0,1.3405,116,7,5,7,3,0,3,0,3,"Low",-2,2
"1932",13,95,0,1.1951,25,124,3,6,4,1,5,1,3,"High",-3,3
"1933",13,96,1,1.5887,17,90,8,3,1,1,2,1,3,"Low",5,5
"1934",13,97,1,1.706,67,138,7,6,0,0,0,0,3,"Low",1,1
"1935",13,98,1,1.9518,24,76,6,4,0,2,2,0,3,"Low",2,2
"1936",13,99,1,3.488,79,29,7,4,3,3,6,3,3,"High",3,3
"1937",13,100,0,1.4566,46,58,2,3,0,3,3,3,3,"Low",-1,1
"1938",13,101,1,1.7734,40,80,5,6,2,4,6,2,3,"High",-1,1
"1939",13,102,1,1.1141,106,110,10,6,1,2,3,1,3,"Low",4,4
"1940",13,103,1,1.6357,58,116,3,5,4,4,8,4,3,"High",-2,2
"1941",13,104,0,2.1164,78,115,8,8,2,0,2,0,3,"Low",0,0
"1942",13,105,1,1.9805,107,14,8,5,0,3,3,0,3,"Low",3,3
"1943",13,106,1,1.7313,64,24,10,6,0,1,1,0,3,"Low",4,4
"1944",13,107,0,3.8121,68,96,1,4,0,0,0,0,3,"Low",-3,3
"1945",13,108,0,2.6088,61,128,8,9,1,3,4,3,3,"High",-1,1
"1946",13,109,0,1.4629,20,56,4,8,0,1,1,1,3,"Low",-4,4
"1947",13,110,1,1.2996,135,136,6,5,2,4,6,2,3,"High",1,1
"1948",13,111,1,1.247,3,113,6,3,1,1,2,1,3,"Low",3,3
"1949",13,112,0,1.7057,4,141,6,7,3,1,4,1,3,"High",-1,1
"1950",13,113,1,1.219,107,4,8,6,1,4,5,1,3,"High",2,2
"1951",13,114,0,1.3284,55,12,4,7,1,2,3,2,3,"Low",-3,3
"1952",13,115,1,2.6244,29,71,4,1,4,0,4,4,3,"High",3,3
"1953",13,116,0,2.2578,137,62,1,5,0,2,2,2,3,"Low",-4,4
"1954",13,117,0,4.7987,28,96,3,4,1,1,2,1,3,"Low",-1,1
"1955",13,118,0,1.4348,86,95,6,8,3,1,4,1,3,"High",-2,2
"1956",13,119,1,1.6741,86,65,6,5,4,1,5,4,3,"High",1,1
"1957",13,120,1,1.6451,24,55,6,4,2,2,4,2,3,"High",2,2
"1958",13,121,0,1.2631,28,91,3,6,2,1,3,1,3,"Low",-3,3
"1959",13,122,0,1.8337,90,82,3,5,2,2,4,2,3,"High",-2,2
"1960",13,123,0,1.395,122,127,5,5,3,3,6,3,3,"High",0,0
"1961",13,124,1,1.5017,110,37,6,5,3,1,4,3,3,"High",1,1
"1962",13,125,1,1.3419,22,67,10,7,2,1,3,2,3,"Low",3,3
"1963",13,126,0,1.2127,2,56,4,8,3,2,5,2,3,"High",-4,4
"1964",13,127,0,1.4833,140,40,2,5,2,3,5,3,3,"High",-3,3
"1965",13,128,1,1.6015,107,5,8,7,2,0,2,2,3,"Low",1,1
"1966",13,129,1,1.6428,23,27,7,4,4,2,6,4,3,"High",3,3
"1967",13,130,1,5.004,128,100,9,7,4,2,6,4,3,"High",2,2
"1968",13,131,0,4.6643,108,68,6,1,3,1,4,1,3,"High",5,5
"1969",13,132,0,2.7912,17,78,8,8,2,3,5,3,3,"High",0,0
"1970",13,133,0,1.3621,87,53,2,7,0,2,2,2,3,"Low",-5,5
"1971",13,134,0,1.6407,65,105,5,4,2,2,4,2,3,"High",1,1
"1972",13,135,0,1.6721,66,122,5,5,0,4,4,4,3,"High",0,0
"1973",13,136,1,1.9354,22,42,10,8,3,2,5,3,3,"High",2,2
"1974",13,137,1,1.5057,10,66,7,5,1,1,2,1,3,"Low",2,2
"1975",13,138,0,2.1705,2,14,4,5,4,4,8,4,3,"High",-1,1
"1976",13,139,1,2.5392,103,41,6,3,2,1,3,2,3,"Low",3,3
"1977",13,140,0,1.6577,33,12,7,7,1,3,4,3,3,"High",0,0
"1978",13,141,1,1.5152,61,39,8,4,2,2,4,2,3,"High",4,4
"1979",13,142,0,1.9165,120,115,8,8,1,1,2,1,3,"Low",0,0
"1980",13,143,0,1.5081,37,52,5,7,2,1,3,1,3,"Low",-2,2
"1981",13,144,1,1.3919,60,35,9,4,1,3,4,1,3,"High",5,5
"1982",13,145,1,2.7976,96,68,4,1,2,2,4,2,3,"High",3,3
"1983",13,146,1,1.5061,10,126,7,6,2,2,4,2,3,"High",1,1
"1984",13,147,1,1.0543,61,118,8,3,3,3,6,3,3,"High",5,5
"1985",13,148,1,2.5816,56,100,8,7,3,3,6,3,3,"High",1,1
"1986",13,149,1,78.4966,28,55,3,4,3,3,6,3,3,"High",-1,1
"1987",13,150,0,1.168,66,8,5,7,2,3,5,3,3,"High",-2,2
"1988",13,151,1,1.634,120,90,8,3,2,3,5,2,3,"High",5,5
"1989",13,152,0,1.4799,65,113,5,3,3,2,5,2,3,"High",2,2
"1990",13,153,0,1.164,19,13,7,7,0,0,0,0,3,"Low",0,0
"1991",13,154,1,1.1743,95,19,8,7,2,1,3,2,3,"Low",1,1
"1992",13,155,1,3.0194,103,117,6,4,3,0,3,3,3,"Low",2,2
"1993",13,156,0,1.1514,79,120,7,8,4,3,7,3,3,"High",-1,1
"1994",13,157,1,1.0636,77,76,6,4,1,3,4,1,3,"High",2,2
"1995",13,158,0,1.0878,56,77,8,6,4,2,6,2,3,"High",2,2
"1996",13,159,0,1.1851,118,82,3,5,4,3,7,3,3,"High",-2,2
"1997",13,160,0,1.2983,102,77,6,6,0,3,3,3,3,"Low",0,0
"1998",13,161,0,2.1465,102,105,6,4,1,3,4,3,3,"High",2,2
"1999",13,162,0,1.3039,48,106,6,10,2,2,4,2,3,"High",-4,4
"2000",13,163,0,1.3977,87,6,2,6,1,0,1,0,3,"Low",-4,4
"2001",13,164,1,1.4957,20,41,4,3,1,2,3,1,3,"Low",1,1
"2002",13,165,0,1.0294,102,95,6,8,2,3,5,3,3,"High",-2,2
"2003",13,166,0,1.1726,141,60,7,9,2,2,4,2,3,"High",-2,2
"2004",13,167,0,1.1965,41,105,3,4,3,4,7,4,3,"High",-1,1
"2005",13,168,0,1.1692,103,141,6,7,4,3,7,3,3,"High",-1,1
"2006",13,169,0,1.1121,28,6,3,6,4,1,5,1,3,"High",-3,3
"2007",13,170,0,1.8781,91,142,6,9,2,1,3,1,3,"Low",-3,3
"2008",13,171,1,1.3614,61,20,8,4,4,2,6,4,3,"High",4,4
"2009",13,172,0,1.4219,119,138,2,6,1,1,2,1,3,"Low",-4,4
"2010",13,173,0,1.213,84,126,1,6,0,3,3,3,3,"Low",-5,5
"2011",13,174,0,1.4744,46,108,2,6,1,4,5,4,3,"High",-4,4
"2012",13,175,1,1.1783,33,90,7,3,2,4,6,2,3,"High",4,4
"2013",13,176,1,1.3504,42,114,8,4,3,1,4,3,3,"High",4,4
"2014",13,177,0,1.5102,146,47,7,8,1,2,3,2,3,"Low",-1,1
"2015",13,178,1,2.0225,104,102,7,6,3,3,6,3,3,"High",1,1
"2016",13,179,1,1.295,52,99,7,4,2,2,4,2,3,"High",3,3
"2017",13,180,1,1.089,130,20,8,4,4,3,7,4,3,"High",4,4
"2018",13,181,0,1.2666,55,117,4,4,4,1,5,1,3,"High",0,0
"2019",13,182,0,1.2191,143,117,3,4,1,2,3,2,3,"Low",-1,1
"2020",13,183,0,1.1218,84,48,1,6,1,3,4,3,3,"High",-5,5
"2021",13,184,1,1.0264,13,129,7,6,1,3,4,1,3,"High",1,1
"2022",13,185,1,1.1011,64,146,10,7,1,2,3,1,3,"Low",3,3
"2023",13,186,0,0.67941,15,64,10,10,4,2,6,2,3,"High",0,0
"2024",13,187,1,1.1934,6,117,6,4,2,3,5,2,3,"High",2,2
"2025",13,188,0,1.0314,87,48,2,6,2,4,6,4,3,"High",-4,4
"2026",13,189,1,1.6134,37,41,5,3,3,4,7,3,3,"High",2,2
"2027",13,190,1,1.1443,110,68,6,1,4,3,7,4,3,"High",5,5
"2028",13,191,0,1.1075,83,102,1,6,0,4,4,4,3,"High",-5,5
"2029",13,192,1,2.1754,42,115,8,8,4,2,6,4,3,"High",0,0
"2030",13,193,0,1.4267,68,117,1,4,4,4,8,4,3,"High",-3,3
"2031",13,194,1,1.057,53,99,7,4,3,3,6,3,3,"High",3,3
"2032",13,195,0,1.1683,49,126,5,6,3,4,7,4,3,"High",-1,1
"2033",13,196,1,5.6417,87,140,2,2,3,3,6,3,3,"High",0,0
"2034",13,197,1,1.0345,39,37,4,5,3,4,7,3,3,"High",-1,1
"2035",13,198,0,1.3892,87,146,2,7,4,3,7,3,3,"High",-5,5
"2036",13,199,0,2.4604,113,40,3,5,3,4,7,4,3,"High",-2,2
"2037",13,200,1,0.94185,12,35,7,4,4,4,8,4,3,"High",3,3
"2038",14,1,1,2.8854,136,104,5,1,0,0,0,0,3,"Low",4,4
"2039",14,2,0,1.7122,43,35,6,10,0,0,0,0,3,"Low",-4,4
"2040",14,3,0,1.4972,32,127,2,2,0,0,0,0,3,"Low",0,0
"2041",14,4,1,2.9554,14,9,4,1,0,0,0,0,3,"Low",3,3
"2042",14,5,0,1.9957,114,107,3,4,0,0,0,0,3,"Low",-1,1
"2043",14,6,0,1.2823,110,115,6,7,0,0,0,0,3,"Low",-1,1
"2044",14,7,1,3.0304,123,71,8,5,0,0,0,0,3,"Low",3,3
"2045",14,8,1,5.3069,107,53,4,4,1,0,1,1,3,"Low",0,0
"2046",14,9,1,2.6449,39,11,4,5,0,0,0,0,3,"Low",-1,1
"2047",14,10,1,5.6575,71,99,5,1,1,0,1,1,3,"Low",4,4
"2048",14,11,0,4.4856,11,128,5,2,1,0,1,0,3,"Low",3,3
"2049",14,12,0,2.1384,128,71,2,5,1,2,3,2,3,"Low",-3,3
"2050",14,13,0,1.4685,25,97,1,6,0,0,0,0,3,"Low",-5,5
"2051",14,14,0,1.8352,99,105,1,2,1,0,1,0,3,"Low",-1,1
"2052",14,15,0,3.6404,69,85,6,7,0,0,0,0,3,"Low",-1,1
"2053",14,16,1,5.6536,51,5,6,6,0,0,0,0,3,"Low",0,0
"2054",14,17,0,1.4028,11,51,5,6,2,1,3,1,3,"Low",-1,1
"2055",14,18,0,1.1937,104,33,1,6,1,0,1,0,3,"Low",-5,5
"2056",14,19,1,2.1815,106,18,4,2,0,0,0,0,3,"Low",2,2
"2057",14,20,0,2.045,13,105,5,2,0,1,1,1,3,"Low",3,3
"2058",14,21,0,1.4111,62,115,2,7,0,1,1,1,3,"Low",-5,5
"2059",14,22,1,2.0159,2,106,3,4,0,1,1,0,3,"Low",-1,1
"2060",14,23,0,1.6909,62,106,2,4,1,2,3,2,3,"Low",-2,2
"2061",14,24,0,2.1003,135,132,2,4,0,0,0,0,3,"Low",-2,2
"2062",14,25,0,3.867,61,45,2,2,0,0,0,0,3,"Low",0,0
"2063",14,26,0,2.599,32,107,2,4,1,2,3,2,3,"Low",-2,2
"2064",14,27,0,1.4051,121,139,3,5,0,0,0,0,3,"Low",-2,2
"2065",14,28,0,2.1246,128,45,2,2,2,1,3,1,3,"Low",0,0
"2066",14,29,1,3.0298,137,37,5,2,0,0,0,0,3,"Low",3,3
"2067",14,30,1,1.8652,31,117,5,1,0,0,0,0,3,"Low",4,4
"2068",14,31,1,6.8672,66,9,3,1,0,1,1,0,3,"Low",2,2
"2069",14,32,1,2.5527,7,47,7,6,0,0,0,0,3,"Low",1,1
"2070",14,33,1,2.8167,30,60,7,3,0,0,0,0,3,"Low",4,4
"2071",14,34,0,1.5341,137,127,5,2,1,1,2,1,3,"Low",3,3
"2072",14,35,0,2.6468,147,33,3,6,0,1,1,1,3,"Low",-3,3
"2073",14,36,0,3.371,53,108,4,5,1,0,1,0,3,"Low",-1,1
"2074",14,37,1,2.2263,38,137,4,5,0,2,2,0,3,"Low",-1,1
"2075",14,38,0,1.9811,27,52,1,3,0,0,0,0,3,"Low",-2,2
"2076",14,39,0,4.0598,147,139,3,5,1,1,2,1,3,"Low",-2,2
"2077",14,40,1,3.265,37,9,2,1,1,2,3,1,3,"Low",1,1
"2078",14,41,0,2.02,98,29,7,8,0,0,0,0,3,"Low",-1,1
"2079",14,42,0,2.8239,47,115,6,7,1,2,3,2,3,"Low",-1,1
"2080",14,43,1,2.062,79,99,1,1,0,2,2,0,3,"Low",0,0
"2081",14,44,0,7.2738,44,97,7,6,0,1,1,1,3,"Low",1,1
"2082",14,45,1,1.5461,110,117,6,1,1,1,2,1,3,"Low",5,5
"2083",14,46,0,1.7143,55,132,1,4,0,1,1,1,3,"Low",-3,3
"2084",14,47,0,3.4275,115,16,7,4,3,0,3,0,3,"Low",3,3
"2085",14,48,1,1.6888,71,18,5,2,3,1,4,3,3,"High",3,3
"2086",14,49,0,2.4676,110,115,6,7,2,4,6,4,3,"High",-1,1
"2087",14,50,1,3.343,61,106,2,4,1,3,4,1,3,"High",-2,2
"2088",14,51,1,2.604,29,110,8,6,1,3,4,1,3,"High",2,2
"2089",14,52,0,5.274,128,23,2,1,3,0,3,0,3,"Low",1,1
"2090",14,53,0,2.4679,14,91,4,4,1,0,1,0,3,"Low",0,0
"2091",14,54,1,1.5921,29,106,8,4,2,4,6,2,3,"High",4,4
"2092",14,55,1,1.1834,29,53,8,4,3,2,5,3,3,"High",4,4
"2093",14,56,0,3.1316,120,131,2,4,0,0,0,0,3,"Low",-2,2
"2094",14,57,1,2.6281,43,20,6,4,1,0,1,1,3,"Low",2,2
"2095",14,58,0,2.0095,3,85,6,7,0,1,1,1,3,"Low",-1,1
"2096",14,59,1,4.0079,53,25,4,1,3,1,4,3,3,"High",3,3
"2097",14,60,0,1.9258,65,45,2,2,0,2,2,2,3,"Low",0,0
"2098",14,61,1,1.647,50,132,7,4,0,2,2,0,3,"Low",3,3
"2099",14,62,0,1.7979,58,51,3,6,0,2,2,2,3,"Low",-3,3
"2100",14,63,0,1.27,20,143,4,5,1,0,1,0,3,"Low",-1,1
"2101",14,64,1,2.6091,88,117,2,1,0,2,2,0,3,"Low",1,1
"2102",14,65,0,6.9193,66,14,3,4,1,2,3,2,3,"Low",-1,1
"2103",14,66,0,1.4174,99,147,1,3,3,2,5,2,3,"High",-2,2
"2104",14,67,1,4.456,41,2,3,3,0,1,1,0,3,"Low",0,0
"2105",14,68,0,4.676,131,142,4,5,1,0,1,0,3,"Low",-1,1
"2106",14,69,0,2.4876,128,136,2,5,4,1,5,1,3,"High",-3,3
"2107",14,70,0,1.9614,31,69,5,6,1,1,2,1,3,"Low",-1,1
"2108",14,71,0,3.1864,105,85,2,7,2,2,4,2,3,"High",-5,5
"2109",14,72,1,1.7544,65,32,2,2,1,2,3,1,3,"Low",0,0
"2110",14,73,0,1.8837,60,79,3,1,1,1,2,1,3,"Low",2,2
"2111",14,74,0,1.8538,134,110,7,6,0,4,4,4,3,"High",1,1
"2112",14,75,1,2.2985,35,139,10,5,1,2,3,1,3,"Low",5,5
"2113",14,76,0,1.9165,60,20,3,4,2,2,4,2,3,"High",-1,1
"2114",14,77,0,2.9899,90,19,4,7,0,0,0,0,3,"Low",-3,3
"2115",14,78,0,3.0519,136,132,5,4,2,3,5,3,3,"High",1,1
"2116",14,79,1,7.5764,23,129,1,2,1,0,1,1,3,"Low",-1,1
"2117",14,80,0,2.6421,1,6,5,5,0,0,0,0,3,"Low",0,0
"2118",14,81,0,1.3508,130,38,1,4,0,1,1,1,3,"Low",-3,3
"2119",14,82,0,1,60,5,3,6,3,1,4,1,3,"High",-3,3
"2120",14,83,0,2.2276,32,57,2,1,3,0,3,0,3,"Low",1,1
"2121",14,84,0,2.9849,111,112,4,8,0,0,0,0,3,"Low",-4,4
"2122",14,85,1,1.5017,52,105,3,2,1,3,4,1,3,"High",1,1
"2123",14,86,0,1.313,25,90,1,4,2,1,3,1,3,"Low",-3,3
"2124",14,87,1,1.4823,19,111,7,4,1,1,2,1,3,"Low",3,3
"2125",14,88,1,1.8504,97,18,6,2,2,2,4,2,3,"High",4,4
"2126",14,89,0,1.7638,104,38,1,4,2,2,4,2,3,"High",-3,3
"2127",14,90,1,3.7065,20,93,4,1,3,0,3,3,3,"Low",3,3
"2128",14,91,1,3.6605,100,32,1,2,0,4,4,0,3,"High",-1,1
"2129",14,92,1,2.5685,44,91,7,4,1,1,2,1,3,"Low",3,3
"2130",14,93,1,2.0691,38,27,4,1,3,1,4,3,3,"High",3,3
"2131",14,94,0,1.7761,101,142,5,5,0,1,1,1,3,"Low",0,0
"2132",14,95,0,2.2553,112,50,8,7,1,1,2,1,3,"Low",1,1
"2133",14,96,0,1.4988,124,20,2,4,0,4,4,4,3,"High",-2,2
"2134",14,97,1,4.4921,74,91,9,4,0,2,2,0,3,"Low",5,5
"2135",14,98,0,1.7115,138,47,7,6,0,2,2,2,3,"Low",1,1
"2136",14,99,1,4.1474,33,68,6,4,2,0,2,2,3,"Low",2,2
"2137",14,100,1,2.3381,104,121,1,3,3,1,4,3,3,"High",-2,2
"2138",14,101,1,2.0927,135,27,2,1,1,2,3,1,3,"Low",1,1
"2139",14,102,0,1.6234,93,4,1,4,1,0,1,0,3,"Low",-3,3
"2140",14,103,0,1.1982,23,47,1,6,2,3,5,3,3,"High",-5,5
"2141",14,104,0,2.7159,105,16,2,4,4,1,5,1,3,"High",-2,2
"2142",14,105,0,5.8259,61,104,2,1,2,4,6,4,3,"High",1,1
"2143",14,106,1,1.4403,41,25,3,1,1,3,4,1,3,"High",2,2
"2144",14,107,1,1.9729,136,135,5,2,3,2,5,3,3,"High",3,3
"2145",14,108,1,1.4282,44,37,7,2,2,2,4,2,3,"High",5,5
"2146",14,109,0,2.8775,47,30,6,7,4,1,5,1,3,"High",-1,1
"2147",14,110,0,1.7135,1,138,5,7,1,1,2,1,3,"Low",-2,2
"2148",14,111,1,6.6482,43,93,6,1,2,2,4,2,3,"High",5,5
"2149",14,112,1,3.0925,114,124,3,2,1,1,2,1,3,"Low",1,1
"2150",14,113,0,1.2798,19,127,7,2,2,2,4,2,3,"High",5,5
"2151",14,114,0,3.588,63,121,2,3,0,2,2,2,3,"Low",-1,1
"2152",14,115,1,2.1144,136,111,5,4,4,2,6,4,3,"High",1,1
"2153",14,116,0,5.516,133,45,3,2,0,3,3,3,3,"Low",1,1
"2154",14,117,1,2.6533,15,44,7,7,0,3,3,0,3,"Low",0,0
"2155",14,118,1,2.7216,16,147,4,3,2,3,5,2,3,"High",1,1
"2156",14,119,1,1.4522,90,132,4,4,2,4,6,2,3,"High",0,0
"2157",14,120,1,1.7854,15,112,7,8,1,2,3,1,3,"Low",-1,1
"2158",14,121,1,1.3677,52,88,3,2,2,1,3,2,3,"Low",1,1
"2159",14,122,1,5.807,44,129,7,2,4,1,5,4,3,"High",5,5
"2160",14,123,1,6.5111,114,9,3,1,2,3,5,2,3,"High",2,2
"2161",14,124,0,1.7613,61,111,2,4,3,3,6,3,3,"High",-2,2
"2162",14,125,1,2.1393,133,60,3,3,1,4,5,1,3,"High",0,0
"2163",14,126,1,5.1773,53,65,4,2,4,2,6,4,3,"High",2,2
"2164",14,127,1,7.2332,90,31,4,5,3,2,5,3,3,"High",-1,1
"2165",14,128,1,1.5314,68,111,4,4,1,4,5,1,3,"High",0,0
"2166",14,129,0,1.8275,14,7,4,7,3,1,4,1,3,"High",-3,3
"2167",14,130,0,1.3681,39,107,4,4,1,3,4,3,3,"High",0,0
"2168",14,131,1,1.4709,65,61,2,2,3,4,7,3,3,"High",0,0
"2169",14,132,0,5.2562,138,5,7,6,2,2,4,2,3,"High",1,1
"2170",14,133,0,1.0601,18,41,2,3,3,2,5,2,3,"High",-1,1
"2171",14,134,1,0.97834,143,121,5,3,1,3,4,1,3,"High",2,2
"2172",14,135,0,1.2178,37,139,2,5,3,3,6,3,3,"High",-3,3
"2173",14,136,0,1.791,145,126,2,3,0,0,0,0,3,"Low",-1,1
"2174",14,137,0,1.8545,88,81,2,1,2,0,2,0,3,"Low",1,1
"2175",14,138,1,2.1904,126,71,3,5,1,4,5,1,3,"High",-2,2
"2176",14,139,0,1.1246,62,97,2,6,2,3,5,3,3,"High",-4,4
"2177",14,140,0,1.2764,14,147,4,3,4,4,8,4,3,"High",1,1
"2178",14,141,1,1.4771,23,124,1,2,3,2,5,3,3,"High",-1,1
"2179",14,142,0,1.7611,38,144,4,5,4,0,4,0,3,"High",-1,1
"2180",14,143,1,2.1854,12,91,8,4,0,3,3,0,3,"Low",4,4
"2181",14,144,1,3.2318,138,135,7,2,3,3,6,3,3,"High",5,5
"2182",14,145,1,5.9005,133,114,3,3,2,3,5,2,3,"High",0,0
"2183",14,146,0,2.198,99,16,1,4,4,3,7,3,3,"High",-3,3
"2184",14,147,1,0.94871,7,50,7,7,2,2,4,2,3,"High",0,0
"2185",14,148,0,1.6463,58,98,3,7,1,1,2,1,3,"Low",-4,4
"2186",14,149,0,1.97,46,2,2,3,0,2,2,2,3,"Low",-1,1
"2187",14,150,0,2.7796,41,139,3,5,3,4,7,4,3,"High",-2,2
"2188",14,151,1,1.3998,23,18,1,2,4,4,8,4,3,"High",-1,1
"2189",14,152,1,1.6058,145,66,2,3,1,2,3,1,3,"Low",-1,1
"2190",14,153,0,1.485,55,114,1,3,1,4,5,4,3,"High",-2,2
"2191",14,154,1,2.032,51,138,6,7,3,4,7,3,3,"High",-1,1
"2192",14,155,0,5.2947,123,2,8,3,1,3,4,3,3,"High",5,5
"2193",14,156,0,1.2415,45,108,2,5,4,1,5,1,3,"High",-3,3
"2194",14,157,1,1.5946,124,100,2,1,3,1,4,3,3,"High",1,1
"2195",14,158,1,1.4333,69,124,6,2,2,4,6,2,3,"High",4,4
"2196",14,159,0,2.0783,108,141,5,10,2,0,2,0,3,"Low",-5,5
"2197",14,160,1,2.1462,55,25,1,1,2,4,6,2,3,"High",0,0
"2198",14,161,1,1.4982,42,2,8,3,0,4,4,0,3,"High",5,5
"2199",14,162,0,3.421,68,7,4,7,2,3,5,3,3,"High",-3,3
"2200",14,163,0,1.2504,13,102,5,1,1,0,1,0,3,"Low",4,4
"2201",14,164,0,1.2178,130,126,1,3,1,2,3,2,3,"Low",-2,2
"2202",14,165,0,3.1884,135,137,2,5,4,3,7,3,3,"High",-3,3
"2203",14,166,1,1.3243,68,3,4,6,3,1,4,3,3,"High",-2,2
"2204",14,167,0,1.5704,102,58,1,3,1,2,3,2,3,"Low",-2,2
"2205",14,168,1,1.306,85,31,7,5,3,3,6,3,3,"High",2,2
"2206",14,169,1,6.0038,108,39,5,4,3,2,5,3,3,"High",1,1
"2207",14,170,1,0.92979,107,79,4,1,4,2,6,4,3,"High",3,3
"2208",14,171,1,1.2714,29,142,8,5,4,2,6,4,3,"High",3,3
"2209",14,172,1,2.562,65,68,2,4,4,4,8,4,3,"High",-2,2
"2210",14,173,0,1.4019,57,5,1,6,1,3,4,3,3,"High",-5,5
"2211",14,174,1,1.6075,90,134,4,7,4,1,5,4,3,"High",-3,3
"2212",14,175,0,1.3408,27,5,1,6,3,4,7,4,3,"High",-5,5
"2213",14,176,1,1.498,142,91,5,4,3,4,7,3,3,"High",1,1
"2214",14,177,1,1.5082,81,100,1,1,1,2,3,1,3,"Low",0,0
"2215",14,178,1,2.0037,50,16,7,4,3,4,7,3,3,"High",3,3
"2216",14,179,0,1.4501,57,142,1,5,2,4,6,4,3,"High",-4,4
"2217",14,180,0,0.98245,130,33,1,6,2,3,5,3,3,"High",-5,5
"2218",14,181,1,3.0344,79,100,1,1,3,3,6,3,3,"High",0,0
"2219",14,182,1,3.9957,33,43,6,6,4,3,7,4,3,"High",0,0
"2220",14,183,0,2.8637,37,79,2,1,4,4,8,4,3,"High",1,1
"2221",14,184,0,1.9632,133,1,3,5,3,2,5,2,3,"High",-2,2
"2222",14,185,1,1.4344,15,19,7,7,2,3,5,2,3,"High",0,0
"2223",14,186,0,1.272,62,137,2,5,3,4,7,4,3,"High",-3,3
"2224",14,187,0,1.2558,63,11,2,5,1,3,4,3,3,"High",-3,3
"2225",14,188,0,2.748,46,98,2,7,1,2,3,2,3,"Low",-5,5
"2226",14,189,0,1.6438,51,85,6,7,4,4,8,4,3,"High",-1,1
"2227",14,190,0,3.3441,133,134,3,7,4,2,6,2,3,"High",-4,4
"2228",14,191,1,2.1206,144,15,5,7,1,3,4,1,3,"High",-2,2
"2229",14,192,1,2.0093,48,55,1,1,0,3,3,0,3,"Low",0,0
"2230",14,193,0,6.0234,58,43,3,6,3,4,7,4,3,"High",-3,3
"2231",14,194,0,1.3915,41,34,3,8,4,0,4,0,3,"High",-5,5
"2232",14,195,1,2.3182,6,39,5,4,1,3,4,1,3,"High",1,1
"2233",14,196,0,1.4235,48,6,1,5,1,2,3,2,3,"Low",-4,4
"2234",14,197,0,1.8519,134,112,7,8,3,3,6,3,3,"High",-1,1
"2235",14,198,1,1.6316,42,134,8,7,1,4,5,1,3,"High",1,1
"2236",14,199,0,1.557,100,127,1,2,4,3,7,3,3,"High",-1,1
"2237",14,200,1,1.7724,88,48,2,1,3,2,5,3,3,"High",1,1
"2238",15,1,1,1.3022,17,24,4,6,0,0,0,0,3,"Low",-2,2
"2239",15,2,1,2.496,55,2,10,7,0,0,0,0,3,"Low",3,3
"2240",15,3,1,1.7522,128,24,3,6,0,1,1,0,3,"Low",-3,3
"2241",15,4,0,4.0087,10,26,3,2,0,0,0,0,3,"Low",1,1
"2242",15,5,0,7.6168,79,146,4,2,0,0,0,0,3,"Low",2,2
"2243",15,6,1,1.5022,90,6,6,3,0,0,0,0,3,"Low",3,3
"2244",15,7,0,3.8561,11,134,3,2,0,0,0,0,3,"Low",1,1
"2245",15,8,0,1.9044,18,102,6,7,0,0,0,0,3,"Low",-1,1
"2246",15,9,0,4.3964,124,146,4,2,0,1,1,1,3,"Low",2,2
"2247",15,10,0,1.6519,79,122,4,5,1,0,1,0,3,"Low",-1,1
"2248",15,11,1,1.1599,41,118,7,3,0,0,0,0,3,"Low",4,4
"2249",15,12,0,1.8,25,114,5,6,0,0,0,0,3,"Low",-1,1
"2250",15,13,0,2.7979,44,66,4,3,0,0,0,0,3,"Low",1,1
"2251",15,14,0,1.5145,117,2,3,7,0,1,1,1,3,"Low",-4,4
"2252",15,15,0,1.3,24,138,6,10,2,0,2,0,3,"Low",-4,4
"2253",15,16,0,3.61,61,84,5,4,0,0,0,0,3,"Low",1,1
"2254",15,17,0,4.9973,46,45,10,10,0,0,0,0,3,"Low",0,0
"2255",15,18,0,1.695,67,102,2,7,0,1,1,1,3,"Low",-5,5
"2256",15,19,1,1.2389,146,142,2,1,2,0,2,2,3,"Low",1,1
"2257",15,20,1,1.389,146,120,2,2,3,0,3,3,3,"Low",0,0
"2258",15,21,0,1.5876,95,128,1,3,0,1,1,1,3,"Low",-2,2
"2259",15,22,1,1.4981,120,68,2,2,1,0,1,1,3,"Low",0,0
"2260",15,23,1,1.2244,30,31,10,6,0,0,0,0,3,"Low",4,4
"2261",15,24,1,1.6056,41,11,7,3,1,1,2,1,3,"Low",4,4
"2262",15,25,0,2.5889,118,3,3,4,1,0,1,0,3,"Low",-1,1
"2263",15,26,1,3.7576,89,126,2,3,0,0,0,0,3,"Low",-1,1
"2264",15,27,0,7.7179,133,17,4,4,0,1,1,1,3,"Low",0,0
"2265",15,28,0,1.1582,32,78,1,2,0,0,0,0,3,"Low",-1,1
"2266",15,29,0,3.3627,128,26,3,2,2,1,3,1,3,"Low",1,1
"2267",15,30,0,3.1185,48,133,4,4,0,1,1,1,3,"Low",0,0
"2268",15,31,0,1.1327,114,30,6,10,1,1,2,1,3,"Low",-4,4
"2269",15,32,1,9.3829,61,5,5,3,1,0,1,1,3,"Low",2,2
"2270",15,33,0,1.5896,79,41,4,7,2,2,4,2,3,"High",-3,3
"2271",15,34,0,1.3441,32,71,1,2,1,0,1,0,3,"Low",-1,1
"2272",15,35,0,2.2581,23,17,2,4,0,2,2,2,3,"Low",-2,2
"2273",15,36,1,5.4402,102,84,7,4,2,1,3,2,3,"Low",3,3
"2274",15,37,0,5.2605,120,14,2,3,2,0,2,0,3,"Low",-1,1
"2275",15,38,0,1.1124,120,102,2,7,3,3,6,3,3,"High",-5,5
"2276",15,39,1,1.3066,21,52,10,7,0,0,0,0,3,"Low",3,3
"2277",15,40,1,2.5774,122,24,5,6,1,3,4,1,3,"High",-1,1
"2278",15,41,0,2.2568,32,131,1,2,2,0,2,0,3,"Low",-1,1
"2279",15,42,0,2.219,18,12,6,3,1,0,1,0,3,"Low",3,3
"2280",15,43,1,8.9193,102,34,7,3,4,0,4,4,3,"High",4,4
"2281",15,44,0,3.9529,2,84,7,4,2,2,4,2,3,"High",3,3
"2282",15,45,1,1.3701,10,119,3,3,1,0,1,1,3,"Low",0,0
"2283",15,46,1,1.2263,90,97,6,3,1,0,1,1,3,"Low",3,3
"2284",15,47,1,5.6016,146,131,2,2,4,1,5,4,3,"High",0,0
"2285",15,48,0,1.2875,65,46,5,10,0,1,1,1,3,"Low",-5,5
"2286",15,49,1,6.3784,145,83,10,10,0,0,0,0,3,"Low",0,0
"2287",15,50,1,7.7151,120,99,2,3,4,0,4,4,3,"High",-1,1
"2288",15,51,1,4.5173,128,13,3,5,3,0,3,3,3,"Low",-2,2
"2289",15,52,0,3.1767,9,48,2,4,0,1,1,1,3,"Low",-2,2
"2290",15,53,1,1.0089,51,142,3,1,0,1,1,0,3,"Low",2,2
"2291",15,54,1,1.0944,65,48,5,4,1,2,3,1,3,"Low",1,1
"2292",15,55,1,3.353,117,143,3,2,1,0,1,1,3,"Low",1,1
"2293",15,56,0,2.1064,78,42,2,7,1,0,1,0,3,"Low",-5,5
"2294",15,57,0,6.4118,42,124,7,4,1,1,2,1,3,"Low",3,3
"2295",15,58,1,1.6637,77,141,4,2,0,0,0,0,3,"Low",2,2
"2296",15,59,0,2.8505,98,61,2,5,0,2,2,2,3,"Low",-3,3
"2297",15,60,1,1.6591,113,124,8,4,0,2,2,0,3,"Low",4,4
"2298",15,61,0,2.6952,130,98,1,2,0,1,1,1,3,"Low",-1,1
"2299",15,62,1,1.3953,26,68,2,2,2,1,3,2,3,"Low",0,0
"2300",15,63,1,1.444,17,98,4,2,3,2,5,3,3,"High",2,2
"2301",15,64,1,1.4748,98,37,2,1,3,0,3,3,3,"Low",1,1
"2302",15,65,1,3.8241,113,74,8,6,1,0,1,1,3,"Low",2,2
"2303",15,66,0,2.1749,13,34,5,3,1,1,2,1,3,"Low",2,2
"2304",15,67,1,0.95578,67,130,2,1,1,1,2,1,3,"Low",1,1
"2305",15,68,0,2.8354,133,134,4,2,2,1,3,1,3,"Low",2,2
"2306",15,69,0,1.3381,5,79,3,4,1,3,4,3,3,"High",-1,1
"2307",15,70,0,1.7641,11,25,3,5,2,1,3,1,3,"Low",-2,2
"2308",15,71,0,4.0436,98,60,2,2,4,0,4,0,3,"High",0,0
"2309",15,72,0,1.4226,3,119,4,3,1,1,2,1,3,"Low",1,1
"2310",15,73,0,1.8177,9,142,2,1,1,2,3,2,3,"Low",1,1
"2311",15,74,0,8.5898,12,48,3,4,1,3,4,3,3,"High",-1,1
"2312",15,75,1,1.6927,5,70,3,1,2,0,2,2,3,"Low",2,2
"2313",15,76,1,5.6318,77,99,4,3,1,1,2,1,3,"Low",1,1
"2314",15,77,1,1.822,58,48,5,4,0,4,4,0,3,"High",1,1
"2315",15,78,0,1.4509,130,128,1,3,2,4,6,4,3,"High",-2,2
"2316",15,79,1,6.9666,145,121,10,5,1,0,1,1,3,"Low",5,5
"2317",15,80,0,1.6224,5,20,3,6,3,0,3,0,3,"Low",-3,3
"2318",15,81,1,2.6517,79,124,4,4,4,3,7,4,3,"High",0,0
"2319",15,82,1,3.3758,133,77,4,4,3,2,5,3,3,"High",0,0
"2320",15,83,1,1.4088,103,117,2,3,0,2,2,0,3,"Low",-1,1
"2321",15,84,1,1.3443,51,133,3,4,1,4,5,1,3,"High",-1,1
"2322",15,85,0,0.96245,25,30,5,10,2,2,4,2,3,"High",-5,5
"2323",15,86,1,1.1563,121,141,5,2,1,1,2,1,3,"Low",3,3
"2324",15,87,1,1.1017,34,71,3,2,2,1,3,2,3,"Low",1,1
"2325",15,88,1,1.3083,114,23,6,2,2,1,3,2,3,"Low",4,4
"2326",15,89,0,1.6131,72,124,7,4,0,4,4,4,3,"High",3,3
"2327",15,90,1,1.0258,91,135,5,1,0,0,0,0,3,"Low",4,4
"2328",15,91,1,1.1525,26,42,2,7,3,2,5,3,3,"High",-5,5
"2329",15,92,1,1.0995,143,9,2,2,1,2,3,1,3,"Low",0,0
"2330",15,93,1,1.0208,101,70,6,1,0,1,1,0,3,"Low",5,5
"2331",15,94,1,1.7247,60,4,2,1,1,0,1,1,3,"Low",1,1
"2332",15,95,0,3.0554,13,113,5,8,2,2,4,2,3,"High",-3,3
"2333",15,96,1,8.7206,138,21,10,10,1,1,2,1,3,"Low",0,0
"2334",15,97,0,2.0757,93,60,4,2,0,2,2,2,3,"Low",2,2
"2335",15,98,0,1.5844,25,76,5,3,3,0,3,0,3,"Low",2,2
"2336",15,99,0,1.7815,72,14,7,3,1,1,2,1,3,"Low",4,4
"2337",15,100,1,1.2085,34,24,3,6,3,4,7,3,3,"High",-3,3
"2338",15,101,1,1.1724,74,135,6,1,1,1,2,1,3,"Low",5,5
"2339",15,102,1,1.2764,20,26,6,2,1,4,5,1,3,"High",4,4
"2340",15,103,1,1.2972,67,18,2,6,2,2,4,2,3,"High",-4,4
"2341",15,104,0,1.5633,136,129,6,5,0,0,0,0,3,"Low",1,1
"2342",15,105,0,1.62,52,65,7,5,1,2,3,2,3,"Low",2,2
"2343",15,106,0,5.0273,99,14,3,3,2,2,4,2,3,"High",0,0
"2344",15,107,0,2.5079,65,138,5,10,3,2,5,2,3,"High",-5,5
"2345",15,108,1,1.2994,117,118,3,3,3,2,5,3,3,"High",0,0
"2346",15,109,1,1.798,2,5,7,3,3,4,7,3,3,"High",4,4
"2347",15,110,1,2.8815,12,131,3,2,2,2,4,2,3,"High",1,1
"2348",15,111,1,1.2829,89,9,2,2,1,3,4,1,3,"High",0,0
"2349",15,112,1,1.4468,101,126,6,3,1,1,2,1,3,"Low",3,3
"2350",15,113,0,0.93906,23,34,2,3,2,4,6,4,3,"High",-1,1
"2351",15,114,0,1.9809,10,101,3,6,2,2,4,2,3,"High",-3,3
"2352",15,115,1,4.7315,12,66,3,3,3,1,4,3,3,"High",0,0
"2353",15,116,1,1.3825,18,118,6,3,3,3,6,3,3,"High",3,3
"2354",15,117,0,4.3257,65,134,5,2,4,2,6,2,3,"High",3,3
"2355",15,118,1,1.2638,68,135,2,1,2,2,4,2,3,"High",1,1
"2356",15,119,1,4.4532,30,35,10,10,3,0,3,3,3,"Low",0,0
"2357",15,120,1,2.2078,140,78,5,2,0,2,2,0,3,"Low",3,3
"2358",15,121,1,1.808,61,127,5,4,3,0,3,3,3,"Low",1,1
"2359",15,122,0,2.6965,68,125,2,6,3,0,3,0,3,"Low",-4,4
"2360",15,123,0,1.6355,135,39,1,4,3,0,3,0,3,"Low",-3,3
"2361",15,124,0,3.4334,131,127,2,4,3,1,4,1,3,"High",-2,2
"2362",15,125,0,1.3403,93,100,4,3,1,0,1,0,3,"Low",1,1
"2363",15,126,1,6.1728,138,21,10,10,3,2,5,3,3,"High",0,0
"2364",15,127,1,1.5495,76,27,3,5,1,0,1,1,3,"Low",-2,2
"2365",15,128,0,1.2869,36,114,1,6,0,3,3,3,3,"Low",-5,5
"2366",15,129,1,1.3392,63,68,3,2,0,4,4,0,3,"High",1,1
"2367",15,130,1,1.1803,113,39,8,4,3,1,4,3,3,"High",4,4
"2368",15,131,0,2.8052,91,2,5,7,1,4,5,4,3,"High",-2,2
"2369",15,132,0,0.92709,36,58,1,5,1,1,2,1,3,"Low",-4,4
"2370",15,133,0,0.93657,141,70,2,1,2,2,4,2,3,"High",1,1
"2371",15,134,0,1.5765,9,104,2,3,4,0,4,0,3,"High",-1,1
"2372",15,135,1,1.072,11,37,3,1,3,1,4,3,3,"High",2,2
"2373",15,136,1,1.1166,18,37,6,1,4,2,6,4,3,"High",5,5
"2374",15,137,0,1.9894,70,47,1,4,3,0,3,0,3,"Low",-3,3
"2375",15,138,1,1.5679,62,43,6,2,0,0,0,0,3,"Low",4,4
"2376",15,139,1,1.0573,45,25,10,5,1,4,5,1,3,"High",5,5
"2377",15,140,1,1.4254,61,118,5,3,4,4,8,4,3,"High",2,2
"2378",15,141,1,2.0955,27,100,5,3,1,1,2,1,3,"Low",2,2
"2379",15,142,1,1.5067,117,72,3,7,4,2,6,4,3,"High",-4,4
"2380",15,143,0,1.4357,13,30,5,10,3,4,7,4,3,"High",-5,5
"2381",15,144,1,1.0491,113,119,8,3,4,2,6,4,3,"High",5,5
"2382",15,145,0,2.0848,67,84,2,4,3,3,6,3,3,"High",-2,2
"2383",15,146,1,2.3957,62,20,6,6,1,2,3,1,3,"Low",0,0
"2384",15,147,0,1.3465,142,91,1,5,3,2,5,2,3,"High",-4,4
"2385",15,148,0,1.4983,52,46,7,10,2,2,4,2,3,"High",-3,3
"2386",15,149,0,1.4764,14,134,3,2,3,3,6,3,3,"High",1,1
"2387",15,150,0,1.4637,36,114,1,6,2,4,6,4,3,"High",-5,5
"2388",15,151,1,1.1633,42,131,7,2,3,4,7,3,3,"High",5,5
"2389",15,152,0,0.80354,100,121,3,5,2,2,4,2,3,"High",-2,2
"2390",15,153,1,5.0242,62,84,6,4,2,4,6,2,3,"High",2,2
"2391",15,154,1,1.4537,127,70,4,1,2,4,6,2,3,"High",3,3
"2392",15,155,0,0.8174,141,31,2,6,3,1,4,1,3,"High",-4,4
"2393",15,156,0,0.87303,32,100,1,3,3,3,6,3,3,"High",-2,2
"2394",15,157,1,2.4014,77,143,4,2,3,2,5,3,3,"High",2,2
"2395",15,158,1,1.1135,76,125,3,6,2,1,3,2,3,"Low",-3,3
"2396",15,159,0,0.90704,27,45,5,10,2,2,4,2,3,"High",-5,5
"2397",15,160,1,1.5208,138,58,10,5,4,2,6,4,3,"High",5,5
"2398",15,161,1,2.3635,31,104,6,3,2,1,3,2,3,"Low",3,3
"2399",15,162,0,2.2223,37,127,1,4,3,3,6,3,3,"High",-3,3
"2400",15,163,0,1.2432,39,62,4,6,2,3,5,3,3,"High",-2,2
"2401",15,164,0,4.1513,97,39,3,4,1,3,4,3,3,"High",-1,1
"2402",15,165,0,1.4492,66,41,3,7,2,3,5,3,3,"High",-4,4
"2403",15,166,0,1.0947,7,127,1,4,0,4,4,4,3,"High",-3,3
"2404",15,167,0,2.4512,74,35,6,10,2,1,3,1,3,"Low",-4,4
"2405",15,168,0,2.1261,44,60,4,2,1,3,4,3,3,"High",2,2
"2406",15,169,1,4.7679,66,39,3,4,3,4,7,3,3,"High",-1,1
"2407",15,170,1,2.5201,66,36,3,1,4,3,7,4,3,"High",2,2
"2408",15,171,0,6.9362,112,122,9,5,0,2,2,2,3,"Low",4,4
"2409",15,172,0,2.1204,130,44,1,4,3,2,5,2,3,"High",-3,3
"2410",15,173,0,1.2689,93,91,4,5,2,3,5,3,3,"High",-1,1
"2411",15,174,1,3.4489,47,97,4,3,1,2,3,1,3,"Low",1,1
"2412",15,175,0,8.5983,77,74,4,6,4,3,7,3,3,"High",-2,2
"2413",15,176,1,1.5746,104,126,3,3,2,2,4,2,3,"High",0,0
"2414",15,177,1,6.7824,83,112,10,9,1,1,2,1,3,"Low",1,1
"2415",15,178,1,1.3019,134,71,2,2,4,2,6,4,3,"High",0,0
"2416",15,179,0,1.7989,119,103,3,2,3,1,4,1,3,"High",1,1
"2417",15,180,1,1.9253,13,126,5,3,4,3,7,4,3,"High",2,2
"2418",15,181,1,0.90007,76,72,3,7,3,3,6,3,3,"High",-4,4
"2419",15,182,0,0.92622,42,41,7,7,4,4,8,4,3,"High",0,0
"2420",15,183,1,2.5835,55,121,10,5,1,3,4,1,3,"High",5,5
"2421",15,184,0,1.7882,135,136,1,6,4,1,5,1,3,"High",-5,5
"2422",15,185,0,1.2128,78,121,2,5,3,4,7,4,3,"High",-3,3
"2423",15,186,1,0.88308,76,142,3,1,4,4,8,4,3,"High",2,2
"2424",15,187,0,2.6611,90,58,6,5,2,3,5,3,3,"High",1,1
"2425",15,188,1,1.4722,51,36,3,1,2,4,6,2,3,"High",2,2
"2426",15,189,0,1.329,62,46,6,10,4,3,7,3,3,"High",-4,4
"2427",15,190,0,1.587,10,67,3,2,3,4,7,4,3,"High",1,1
"2428",15,191,1,1.7237,27,141,5,2,3,4,7,3,3,"High",3,3
"2429",15,192,0,1.8386,11,63,3,3,4,1,5,1,3,"High",0,0
"2430",15,193,0,1.5231,72,52,7,7,4,3,7,3,3,"High",0,0
"2431",15,194,1,2.086,55,136,10,6,2,2,4,2,3,"High",4,4
"2432",15,195,1,2.1194,21,55,10,10,3,3,6,3,3,"High",0,0
"2433",15,196,0,7.1327,21,35,10,10,4,2,6,2,3,"High",0,0
"2434",15,197,1,1.3234,31,7,6,1,3,1,4,3,3,"High",5,5
"2435",15,198,0,1.4221,32,140,1,5,4,1,5,1,3,"High",-4,4
"2436",15,199,0,1.3757,126,47,3,4,4,2,6,2,3,"High",-1,1
"2437",15,200,1,2.4642,103,17,2,4,2,4,6,2,3,"High",-2,2
"2438",16,1,1,1.1874,78,127,10,6,0,0,0,0,4,"Low",4,4
"2439",16,2,1,0.94927,48,36,8,9,0,0,0,0,4,"Low",-1,1
"2440",16,3,0,0.90582,114,44,6,10,0,0,0,0,4,"Low",-4,4
"2441",16,4,0,0.93049,48,78,8,10,1,1,2,1,4,"Low",-2,2
"2442",16,5,1,1.0887,10,12,8,4,0,0,0,0,4,"Low",4,4
"2443",16,6,1,1.4668,68,107,10,8,0,0,0,0,4,"Low",2,2
"2444",16,7,1,0.99141,136,18,9,4,0,0,0,0,4,"Low",5,5
"2445",16,8,0,1.3362,12,6,4,8,1,0,1,0,4,"Low",-4,4
"2446",16,9,1,1.2296,137,145,10,7,0,0,0,0,4,"Low",3,3
"2447",16,10,0,1.7917,119,101,3,4,0,0,0,0,4,"Low",-1,1
"2448",16,11,0,0.89646,108,19,10,10,0,0,0,0,4,"Low",0,0
"2449",16,12,0,1.1612,2,63,4,8,0,0,0,0,4,"Low",-4,4
"2450",16,13,1,1.2733,126,86,10,10,0,0,0,0,4,"Low",0,0
"2451",16,14,0,1.5622,131,93,5,8,0,0,0,0,4,"Low",-3,3
"2452",16,15,0,1.4522,7,21,6,4,0,0,0,0,4,"Low",2,2
"2453",16,16,0,0.89229,129,96,8,10,0,0,0,0,4,"Low",-2,2
"2454",16,17,1,1.5878,102,22,3,4,0,0,0,0,4,"Low",-1,1
"2455",16,18,1,1.2436,27,102,7,3,0,1,1,0,4,"Low",4,4
"2456",16,19,1,2.4012,60,2,2,4,0,1,1,0,4,"Low",-2,2
"2457",16,20,0,0.79697,23,136,6,9,0,1,1,1,4,"Low",-3,3
"2458",16,21,0,1.1219,127,137,6,10,1,1,2,1,4,"Low",-4,4
"2459",16,22,0,1.4346,106,21,6,4,0,1,1,1,4,"Low",2,2
"2460",16,23,1,1.372,44,93,10,8,1,1,2,1,4,"Low",2,2
"2461",16,24,1,1.7385,113,131,8,5,0,1,1,0,4,"Low",3,3
"2462",16,25,0,0.76448,63,142,8,9,1,0,1,0,4,"Low",-1,1
"2463",16,26,1,0.95186,85,63,10,8,0,2,2,0,4,"Low",2,2
"2464",16,27,1,1.0306,79,128,10,8,0,0,0,0,4,"Low",2,2
"2465",16,28,1,0.87814,88,119,5,3,0,1,1,0,4,"Low",2,2
"2466",16,29,0,0.75628,31,95,6,4,0,0,0,0,4,"Low",2,2
"2467",16,30,1,1.3756,37,5,4,3,0,0,0,0,4,"Low",1,1
"2468",16,31,1,1.016,10,102,8,3,1,2,3,1,4,"Low",5,5
"2469",16,32,1,2.2463,115,58,6,3,0,0,0,0,4,"Low",3,3
"2470",16,33,1,1.4435,37,131,4,5,1,2,3,1,4,"Low",-1,1
"2471",16,34,0,0.87768,31,3,6,10,1,0,1,0,4,"Low",-4,4
"2472",16,35,1,1.2323,79,96,10,10,1,1,2,1,4,"Low",0,0
"2473",16,36,0,0.9325,63,136,8,9,3,2,5,2,4,"High",-1,1
"2474",16,37,0,2.1672,72,7,1,6,0,1,1,1,4,"Low",-5,5
"2475",16,38,0,1.0952,58,21,3,4,1,2,3,2,4,"Low",-1,1
"2476",16,39,0,3.8759,113,77,8,6,1,0,1,0,4,"Low",2,2
"2477",16,40,0,1.6245,72,111,1,5,1,0,1,0,4,"Low",-4,4
"2478",16,41,1,2.9358,68,96,10,10,1,2,3,1,4,"Low",0,0
"2479",16,42,0,1.0979,31,44,6,10,2,2,4,2,4,"Low",-4,4
"2480",16,43,1,1.1414,137,118,10,7,2,0,2,2,4,"Low",3,3
"2481",16,44,0,0.68727,48,136,8,9,2,3,5,3,4,"High",-1,1
"2482",16,45,0,2.0906,61,121,3,2,0,0,0,0,4,"Low",1,1
"2483",16,46,1,2.1468,33,130,2,1,0,0,0,0,4,"Low",1,1
"2484",16,47,1,1.1156,41,106,9,6,0,1,1,0,4,"Low",3,3
"2485",16,48,1,1.8961,110,23,10,6,0,1,1,0,4,"Low",4,4
"2486",16,49,1,1.2039,141,41,10,9,0,1,1,0,4,"Low",1,1
"2487",16,50,0,1.1959,47,120,2,7,0,0,0,0,4,"Low",-5,5
"2488",16,51,0,1.3268,68,71,10,10,2,0,2,0,4,"Low",0,0
"2489",16,52,1,1.1769,136,127,9,6,4,2,6,4,4,"High",3,3
"2490",16,53,1,1.6201,114,105,6,2,1,0,1,1,4,"Low",4,4
"2491",16,54,0,1.4741,101,31,4,6,1,3,4,3,4,"Low",-2,2
"2492",16,55,0,1.6369,24,5,4,3,0,1,1,1,4,"Low",1,1
"2493",16,56,1,1.6238,127,131,6,5,3,3,6,3,4,"High",1,1
"2494",16,57,1,1.3612,79,82,10,8,2,0,2,2,4,"Low",2,2
"2495",16,58,1,1.9844,60,130,2,1,1,1,2,1,4,"Low",1,1
"2496",16,59,1,1.7968,111,72,5,1,1,2,3,1,4,"Low",4,4
"2497",16,60,0,2.4399,88,135,5,10,1,0,1,0,4,"Low",-5,5
"2498",16,61,1,1.1019,85,108,10,10,1,1,2,1,4,"Low",0,0
"2499",16,62,0,4.3014,107,120,8,7,1,1,2,1,4,"Low",1,1
"2500",16,63,1,2.5041,127,128,6,8,4,1,5,4,4,"High",-2,2
"2501",16,64,0,0.82736,12,25,4,6,2,0,2,0,4,"Low",-2,2
"2502",16,65,1,1.0394,44,7,10,6,3,2,5,3,4,"High",4,4
"2503",16,66,0,0.78162,41,78,9,10,2,2,4,2,4,"Low",-1,1
"2504",16,67,0,1.747,18,100,4,9,1,0,1,0,4,"Low",-5,5
"2505",16,68,0,1.6343,12,37,4,4,3,2,5,2,4,"High",0,0
"2506",16,69,0,1.861,68,108,10,10,3,2,5,2,4,"High",0,0
"2507",16,70,0,1.7457,27,137,7,10,1,3,4,3,4,"Low",-3,3
"2508",16,71,0,2.3686,11,122,8,10,0,0,0,0,4,"Low",-2,2
"2509",16,72,1,1.0805,25,128,6,8,1,2,3,1,4,"Low",-2,2
"2510",16,73,1,1.3233,49,8,10,9,0,0,0,0,4,"Low",1,1
"2511",16,74,0,1.3245,130,2,1,4,2,2,4,2,4,"Low",-3,3
"2512",16,75,0,0.63462,12,120,4,7,4,2,6,2,4,"High",-3,3
"2513",16,76,1,1.334,47,111,2,5,1,2,3,1,4,"Low",-3,3
"2514",16,77,0,1.7019,2,60,4,2,3,2,5,2,4,"High",2,2
"2515",16,78,1,1.2632,27,6,7,8,2,1,3,2,4,"Low",-1,1
"2516",16,79,1,0.9421,142,25,9,6,1,2,3,1,4,"Low",3,3
"2517",16,80,0,0.65146,49,11,10,8,1,1,2,1,4,"Low",2,2
"2518",16,81,1,0.98334,82,87,8,4,1,0,1,1,4,"Low",4,4
"2519",16,82,0,1.3702,24,18,4,4,1,2,3,2,4,"Low",0,0
"2520",16,83,1,0.8594,88,61,5,3,2,1,3,2,4,"Low",2,2
"2521",16,84,0,0.80157,36,19,9,10,1,1,2,1,4,"Low",-1,1
"2522",16,85,0,0.89138,103,122,10,10,0,1,1,1,4,"Low",0,0
"2523",16,86,0,1.0543,2,77,4,6,4,1,5,1,4,"High",-2,2
"2524",16,87,1,0.81085,4,118,10,7,0,1,1,0,4,"Low",3,3
"2525",16,88,1,3.769,118,106,7,6,2,2,4,2,4,"Low",1,1
"2526",16,89,1,0.82353,88,14,5,3,3,0,3,3,4,"Low",2,2
"2527",16,90,1,2.5949,131,61,5,3,4,2,6,4,4,"High",2,2
"2528",16,91,1,0.94386,10,7,8,6,2,3,5,2,4,"High",2,2
"2529",16,92,0,1.6972,120,8,7,9,3,1,4,1,4,"Low",-2,2
"2530",16,93,1,2.3839,115,103,6,10,1,1,2,1,4,"Low",-4,4
"2531",16,94,1,1.9925,137,79,10,10,4,3,7,4,4,"High",0,0
"2532",16,95,1,1.0552,142,103,9,10,2,2,4,2,4,"Low",-1,1
"2533",16,96,1,1.7527,53,41,10,9,0,3,3,0,4,"Low",1,1
"2534",16,97,1,1.1854,142,82,9,8,3,2,5,3,4,"High",1,1
"2535",16,98,0,0.89021,107,41,8,9,2,4,6,4,4,"High",-1,1
"2536",16,99,0,0.87826,119,48,3,8,2,3,5,3,4,"High",-5,5
"2537",16,100,1,0.83233,10,58,8,3,3,2,5,3,4,"High",5,5
"2538",16,101,1,1.4845,61,121,3,2,3,1,4,3,4,"Low",1,1
"2539",16,102,1,1.6232,93,14,8,3,2,1,3,2,4,"Low",5,5
"2540",16,103,0,1.3324,24,18,4,4,2,3,5,3,4,"High",0,0
"2541",16,104,1,1.0925,44,6,10,8,4,2,6,4,4,"High",2,2
"2542",16,105,0,0.73676,105,47,2,2,1,2,3,2,4,"Low",0,0
"2543",16,106,0,1.3958,106,8,6,9,3,2,5,2,4,"High",-3,3
"2544",16,107,1,0.94878,142,117,9,7,4,0,4,4,4,"Low",2,2
"2545",16,108,1,1.0947,111,58,5,3,3,3,6,3,4,"High",2,2
"2546",16,109,0,0.9459,111,63,5,8,4,4,8,4,4,"High",-3,3
"2547",16,110,0,0.68188,135,71,10,10,1,1,2,1,4,"Low",0,0
"2548",16,111,0,4.5968,85,71,10,10,2,2,4,2,4,"Low",0,0
"2549",16,112,1,6.6029,48,87,8,4,4,1,5,4,4,"High",4,4
"2550",16,113,1,1.4983,31,5,6,3,4,2,6,4,4,"High",3,3
"2551",16,114,0,1.4123,36,8,9,9,2,3,5,3,4,"High",0,0
"2552",16,115,1,1.521,18,33,4,2,4,1,5,4,4,"High",2,2
"2553",16,116,1,1.0091,113,23,8,6,2,2,4,2,4,"Low",2,2
"2554",16,117,1,1.0719,88,95,5,4,4,1,5,4,4,"High",1,1
"2555",16,118,0,1.0985,72,77,1,6,3,2,5,2,4,"High",-5,5
"2556",16,119,1,0.90768,129,119,8,3,1,3,4,1,4,"Low",5,5
"2557",16,120,1,0.79841,68,145,10,7,4,1,5,4,4,"High",3,3
"2558",16,121,1,1.0597,37,60,4,2,3,3,6,3,4,"High",2,2
"2559",16,122,1,1.142,107,118,8,7,3,3,6,3,4,"High",1,1
"2560",16,123,1,1.4341,21,14,4,3,3,2,5,3,4,"High",1,1
"2561",16,124,0,0.73453,115,141,6,10,2,1,3,1,4,"Low",-4,4
"2562",16,125,1,1.3908,114,147,6,2,2,0,2,2,4,"Low",4,4
"2563",16,126,0,0.91077,4,100,10,9,1,1,2,1,4,"Low",1,1
"2564",16,127,0,3.0882,85,71,10,10,3,3,6,3,4,"High",0,0
"2565",16,128,0,0.69942,106,10,6,8,4,4,8,4,4,"High",-2,2
"2566",16,129,0,1.0308,107,122,8,10,4,2,6,2,4,"High",-2,2
"2567",16,130,0,0.66741,23,85,6,10,3,4,7,4,4,"High",-4,4
"2568",16,131,1,3.3742,118,14,7,3,4,3,7,4,4,"High",4,4
"2569",16,132,0,0.73372,128,78,8,10,3,3,6,3,4,"High",-2,2
"2570",16,133,0,1.8963,61,105,3,2,4,2,6,2,4,"High",1,1
"2571",16,134,1,0.98016,20,147,4,2,0,1,1,0,4,"Low",2,2
"2572",16,135,0,0.99087,77,86,6,10,3,1,4,1,4,"Low",-4,4
"2573",16,136,0,1.6137,37,33,4,2,4,2,6,2,4,"High",2,2
"2574",16,137,1,0.69319,11,117,8,7,2,1,3,2,4,"Low",1,1
"2575",16,138,0,0.73636,53,27,10,7,1,3,4,3,4,"Low",3,3
"2576",16,139,1,3.4066,33,105,2,2,3,3,6,3,4,"High",0,0
"2577",16,140,1,0.94866,122,145,10,7,3,2,5,3,4,"High",3,3
"2578",16,141,1,2.3407,22,52,4,2,1,0,1,1,4,"Low",2,2
"2579",16,142,1,1.1674,5,24,3,4,3,3,6,3,4,"High",-1,1
"2580",16,143,0,1.7381,105,87,2,4,4,2,6,2,4,"High",-2,2
"2581",16,144,1,1.1987,79,115,10,6,4,3,7,4,4,"High",4,4
"2582",16,145,1,1.2402,101,72,4,1,2,4,6,2,4,"High",3,3
"2583",16,146,1,0.86151,95,87,4,4,2,3,5,2,4,"High",0,0
"2584",16,147,0,1.0922,6,120,8,7,3,4,7,4,4,"High",1,1
"2585",16,148,0,0.63893,145,78,7,10,3,4,7,4,4,"High",-3,3
"2586",16,149,1,0.9083,115,117,6,7,4,2,6,4,4,"High",-1,1
"2587",16,150,1,0.69945,77,87,6,4,4,4,8,4,4,"High",2,2
"2588",16,151,0,1.2917,130,33,1,2,3,4,7,4,4,"High",-1,1
"2589",16,152,1,1.1838,122,113,10,8,4,3,7,4,4,"High",2,2
"2590",16,153,0,1.4971,93,82,8,8,3,3,6,3,4,"High",0,0
"2591",16,154,1,1.5476,71,143,10,9,4,0,4,4,4,"Low",1,1
"2592",16,155,1,1.0011,110,128,10,8,1,4,5,1,4,"High",2,2
"2593",16,156,0,1.9746,3,4,10,10,1,2,3,2,4,"Low",0,0
"2594",16,157,0,0.93067,93,4,8,10,4,3,7,3,4,"High",-2,2
"2595",16,158,1,1.0138,21,52,4,2,4,1,5,4,4,"High",2,2
"2596",16,159,1,1.3484,124,14,2,3,0,4,4,0,4,"Low",-1,1
"2597",16,160,0,0.6388,108,4,10,10,3,4,7,4,4,"High",0,0
"2598",16,161,0,0.65135,58,82,3,8,4,4,8,4,4,"High",-5,5
"2599",16,162,0,0.97532,22,113,4,8,2,4,6,4,4,"High",-4,4
"2600",16,163,0,1.1247,53,3,10,10,2,2,4,2,4,"Low",0,0
"2601",16,164,1,0.96608,95,117,4,7,3,3,6,3,4,"High",-3,3
"2602",16,165,1,1.2922,101,130,4,1,3,4,7,3,4,"High",3,3
"2603",16,166,0,0.72204,24,129,4,8,4,2,6,2,4,"High",-4,4
"2604",16,167,1,1.0468,110,114,10,6,2,3,5,2,4,"High",4,4
"2605",16,168,1,0.9461,19,108,10,10,2,4,6,2,4,"High",0,0
"2606",16,169,1,1.041,43,145,9,7,0,4,4,0,4,"Low",2,2
"2607",16,170,0,1.4209,47,25,2,6,3,3,6,3,4,"High",-4,4
"2608",16,171,1,1.0187,96,36,10,9,3,3,6,3,4,"High",1,1
"2609",16,172,0,1.5762,23,133,6,2,4,0,4,0,4,"Low",4,4
"2610",16,173,1,1.0075,25,8,6,9,4,4,8,4,4,"High",-3,3
"2611",16,174,1,2.1785,95,114,4,6,4,4,8,4,4,"High",-2,2
"2612",16,175,0,1.6817,147,133,2,2,2,1,3,1,4,"Low",0,0
"2613",16,176,0,1.2052,52,7,2,6,2,4,6,4,4,"High",-4,4
"2614",16,177,0,1.5486,117,103,7,10,4,3,7,3,4,"High",-3,3
"2615",16,178,1,1.4904,5,60,3,2,4,4,8,4,4,"High",1,1
"2616",16,179,1,1.8532,20,22,4,4,1,3,4,1,4,"Low",0,0
"2617",16,180,0,0.84448,129,143,8,9,3,1,4,1,4,"Low",-1,1
"2618",16,181,0,0.91403,6,27,8,7,4,4,8,4,4,"High",1,1
"2619",16,182,1,1.3934,96,86,10,10,4,2,6,4,4,"High",0,0
"2620",16,183,1,1.842,133,121,2,2,2,2,4,2,4,"Low",0,0
"2621",16,184,1,1.3886,102,52,3,2,3,3,6,3,4,"High",1,1
"2622",16,185,0,1.5015,70,52,2,2,0,4,4,4,4,"Low",0,0
"2623",16,186,1,0.84884,133,22,2,4,3,4,7,3,4,"High",-2,2
"2624",16,187,0,0.74074,100,11,9,8,2,3,5,3,4,"High",1,1
"2625",16,188,1,0.79533,70,147,2,2,1,3,4,1,4,"Low",0,0
"2626",16,189,1,0.86568,126,43,10,9,1,1,2,1,4,"Low",1,1
"2627",16,190,0,1.2502,124,121,2,2,1,3,4,3,4,"Low",0,0
"2628",16,191,0,0.67633,103,141,10,10,4,2,6,2,4,"High",0,0
"2629",16,192,0,0.75311,49,100,10,9,2,3,5,3,4,"High",1,1
"2630",16,193,1,0.84036,135,49,10,10,2,3,5,2,4,"High",0,0
"2631",16,194,0,4.9104,121,124,2,2,4,2,6,2,4,"High",0,0
"2632",16,195,0,0.85927,53,129,10,8,3,4,7,4,4,"High",2,2
"2633",16,196,1,0.92588,20,70,4,2,2,2,4,2,4,"Low",2,2
"2634",16,197,1,0.70531,141,100,10,9,3,4,7,3,4,"High",1,1
"2635",16,198,0,1.8883,11,135,8,10,4,3,7,3,4,"High",-2,2
"2636",16,199,1,0.77794,141,126,10,10,4,2,6,4,4,"High",0,0
"2637",16,200,0,2.0644,19,126,10,10,3,3,6,3,4,"High",0,0
"2638",17,1,1,1.2645,13,24,5,6,0,0,0,0,4,"Low",-1,1
"2639",17,2,1,1.517,34,68,7,9,0,0,0,0,4,"Low",-2,2
"2640",17,3,1,1.1986,35,120,7,3,0,0,0,0,4,"Low",4,4
"2641",17,4,1,1.3404,7,41,8,7,0,0,0,0,4,"Low",1,1
"2642",17,5,1,1.5414,18,70,6,9,0,0,0,0,4,"Low",-3,3
"2643",17,6,1,1.302,47,112,7,2,0,0,0,0,4,"Low",5,5
"2644",17,7,1,1.1459,65,53,4,1,0,0,0,0,4,"Low",3,3
"2645",17,8,0,3.4361,8,30,5,10,0,0,0,0,4,"Low",-5,5
"2646",17,9,0,1.0866,21,91,5,8,0,0,0,0,4,"Low",-3,3
"2647",17,10,1,1.3716,10,70,6,9,0,1,1,0,4,"Low",-3,3
"2648",17,11,1,1.2569,65,26,4,3,1,0,1,1,4,"Low",1,1
"2649",17,12,0,1.3099,113,48,3,7,0,0,0,0,4,"Low",-4,4
"2650",17,13,1,1.0707,66,27,7,2,0,0,0,0,4,"Low",5,5
"2651",17,14,0,1.2417,21,146,5,3,1,0,1,0,4,"Low",2,2
"2652",17,15,0,1.3781,29,5,6,10,0,0,0,0,4,"Low",-4,4
"2653",17,16,0,1.193,55,141,4,4,0,0,0,0,4,"Low",0,0
"2654",17,17,0,1.1596,24,141,6,4,1,1,2,1,4,"Low",2,2
"2655",17,18,1,1.4957,24,110,6,1,2,0,2,2,4,"Low",5,5
"2656",17,19,1,0.93523,12,18,10,6,0,1,1,0,4,"Low",4,4
"2657",17,20,1,1.7439,24,25,6,1,3,0,3,3,4,"Low",5,5
"2658",17,21,0,2.3277,133,47,7,7,0,1,1,1,4,"Low",0,0
"2659",17,22,1,1.0777,144,131,5,8,0,0,0,0,4,"Low",-3,3
"2660",17,23,0,1.0492,5,79,10,7,1,0,1,0,4,"Low",3,3
"2661",17,24,1,1.5274,16,113,1,3,0,1,1,0,4,"Low",-2,2
"2662",17,25,0,1.0153,68,3,9,10,1,0,1,0,4,"Low",-1,1
"2663",17,26,1,1.4368,79,141,7,4,1,2,3,1,4,"Low",3,3
"2664",17,27,0,0.65735,39,119,8,10,0,0,0,0,4,"Low",-2,2
"2665",17,28,1,0.78676,79,120,7,3,2,1,3,2,4,"Low",4,4
"2666",17,29,0,1.5215,52,110,2,1,0,1,1,1,4,"Low",1,1
"2667",17,30,0,1.0347,24,133,6,7,4,1,5,1,4,"High",-1,1
"2668",17,31,0,1.934,31,55,4,4,0,1,1,1,4,"Low",0,0
"2669",17,32,0,1.1987,18,78,6,8,2,0,2,0,4,"Low",-2,2
"2670",17,33,1,2.3739,17,38,8,7,0,0,0,0,4,"Low",1,1
"2671",17,34,0,1.307,112,133,2,7,1,2,3,2,4,"Low",-5,5
"2672",17,35,1,1.2677,132,3,6,10,0,1,1,0,4,"Low",-4,4
"2673",17,36,0,1.3504,16,8,1,5,1,1,2,1,4,"Low",-4,4
"2674",17,37,1,1.4689,4,9,2,4,0,0,0,0,4,"Low",-2,2
"2675",17,38,0,1.1119,16,57,1,6,2,0,2,0,4,"Low",-5,5
"2676",17,39,1,0.88235,141,127,4,3,3,0,3,3,4,"Low",1,1
"2677",17,40,1,1.0531,20,28,4,1,0,0,0,0,4,"Low",3,3
"2678",17,41,0,1.1212,66,3,7,10,1,2,3,2,4,"Low",-3,3
"2679",17,42,1,1.0838,41,128,7,4,1,0,1,1,4,"Low",3,3
"2680",17,43,1,1.0066,113,54,3,3,2,0,2,2,4,"Low",0,0
"2681",17,44,0,1.07,38,48,7,7,1,1,2,1,4,"Low",0,0
"2682",17,45,1,1.0632,147,51,1,3,0,0,0,0,4,"Low",-2,2
"2683",17,46,1,1.1574,132,10,6,6,1,1,2,1,4,"Low",0,0
"2684",17,47,1,0.96889,27,25,2,1,1,1,2,1,4,"Low",1,1
"2685",17,48,0,0.92787,114,143,4,8,0,0,0,0,4,"Low",-4,4
"2686",17,49,0,1.0976,127,39,3,8,1,1,2,1,4,"Low",-5,5
"2687",17,50,1,1.3716,115,25,3,1,0,2,2,0,4,"Low",2,2
"2688",17,51,0,1.0417,52,1,2,6,1,0,1,0,4,"Low",-4,4
"2689",17,52,1,1.4144,43,37,3,6,0,0,0,0,4,"Low",-3,3
"2690",17,53,0,2.2858,26,133,3,7,1,3,4,3,4,"Low",-4,4
"2691",17,54,1,1.1843,57,68,6,9,1,2,3,1,4,"Low",-3,3
"2692",17,55,0,1.0844,112,47,2,7,2,2,4,2,4,"Low",-5,5
"2693",17,56,1,1.2698,38,52,7,2,2,2,4,2,4,"Low",5,5
"2694",17,57,1,1.242,78,2,8,4,1,0,1,1,4,"Low",4,4
"2695",17,58,1,1.1805,48,115,7,3,2,1,3,2,4,"Low",4,4
"2696",17,59,0,0.85807,52,120,2,3,3,2,5,2,4,"High",-1,1
"2697",17,60,0,1.0719,41,30,7,10,2,1,3,1,4,"Low",-3,3
"2698",17,61,0,1.336,131,68,8,9,1,3,4,3,4,"Low",-1,1
"2699",17,62,1,1.1606,39,71,8,8,2,0,2,2,4,"Low",0,0
"2700",17,63,0,1.0988,128,34,4,7,1,1,2,1,4,"Low",-3,3
"2701",17,64,0,1.3087,21,9,5,4,2,1,3,1,4,"Low",1,1
"2702",17,65,1,2.0353,133,77,7,9,4,0,4,4,4,"Low",-2,2
"2703",17,66,0,1.1223,65,145,4,9,2,0,2,0,4,"Low",-5,5
"2704",17,67,0,0.88094,72,79,2,7,0,3,3,3,4,"Low",-5,5
"2705",17,68,1,0.90103,47,21,7,5,3,3,6,3,4,"High",2,2
"2706",17,69,0,1.4115,143,7,8,8,1,1,2,1,4,"Low",0,0
"2707",17,70,1,1.5498,113,29,3,6,3,1,4,3,4,"Low",-3,3
"2708",17,71,1,1.0031,65,71,4,8,3,1,4,3,4,"Low",-4,4
"2709",17,72,1,0.91108,145,65,9,4,1,4,5,1,4,"High",5,5
"2710",17,73,1,0.89913,54,114,3,4,1,1,2,1,4,"Low",-1,1
"2711",17,74,1,0.86263,48,39,7,8,3,3,6,3,4,"High",-1,1
"2712",17,75,0,1.529,106,11,5,4,0,0,0,0,4,"Low",1,1
"2713",17,76,1,0.85039,79,115,7,3,4,2,6,4,4,"High",4,4
"2714",17,77,1,0.96716,90,97,9,4,0,0,0,0,4,"Low",5,5
"2715",17,78,0,1.2714,25,141,1,4,3,4,7,4,4,"High",-3,3
"2716",17,79,1,2.0988,30,77,10,9,2,1,3,2,4,"Low",1,1
"2717",17,80,0,1.0529,16,72,1,2,3,1,4,1,4,"Low",-1,1
"2718",17,81,0,1.2889,52,113,2,3,4,4,8,4,4,"High",-1,1
"2719",17,82,1,0.94729,72,34,2,7,2,2,4,2,4,"Low",-5,5
"2720",17,83,0,0.82504,7,12,8,10,2,1,3,1,4,"Low",-2,2
"2721",17,84,1,1.2796,131,97,8,4,2,1,3,2,4,"Low",4,4
"2722",17,85,1,1.1063,30,60,10,5,3,0,3,3,4,"Low",5,5
"2723",17,86,0,1.0901,115,41,3,7,3,3,6,3,4,"High",-4,4
"2724",17,87,0,1.5089,120,67,3,5,3,0,3,0,4,"Low",-2,2
"2725",17,88,0,1.4304,53,31,1,4,1,1,2,1,4,"Low",-3,3
"2726",17,89,1,1.1105,43,71,3,8,1,2,3,1,4,"Low",-5,5
"2727",17,90,0,0.67853,144,82,5,10,1,0,1,0,4,"Low",-5,5
"2728",17,91,0,1.4565,18,9,6,4,3,2,5,2,4,"High",2,2
"2729",17,92,0,1.5171,130,1,1,6,0,1,1,1,4,"Low",-5,5
"2730",17,93,0,0.6951,114,66,4,7,2,2,4,2,4,"Low",-3,3
"2731",17,94,1,0.81059,10,57,6,6,2,2,4,2,4,"Low",0,0
"2732",17,95,1,2.2098,122,4,5,2,0,1,1,0,4,"Low",3,3
"2733",17,96,1,0.75588,139,10,10,6,0,3,3,0,4,"Low",4,4
"2734",17,97,0,1.1686,114,26,4,3,3,2,5,2,4,"High",1,1
"2735",17,98,1,0.94397,67,27,5,2,1,2,3,1,4,"Low",3,3
"2736",17,99,0,1.0253,78,1,8,6,2,2,4,2,4,"Low",2,2
"2737",17,100,1,1.152,7,55,8,4,3,2,5,3,4,"High",4,4
"2738",17,101,0,0.73699,144,139,5,10,2,1,3,1,4,"Low",-5,5
"2739",17,102,0,1.1855,56,122,3,5,0,1,1,1,4,"Low",-2,2
"2740",17,103,1,1.1135,55,38,4,7,3,3,6,3,4,"High",-3,3
"2741",17,104,1,5.1309,1,17,6,8,3,1,4,3,4,"Low",-2,2
"2742",17,105,0,1.3879,78,47,8,7,3,4,7,4,4,"High",1,1
"2743",17,106,1,1.0896,42,27,1,2,0,3,3,0,4,"Low",-1,1
"2744",17,107,1,1.2565,82,35,10,7,1,1,2,1,4,"Low",3,3
"2745",17,108,1,1.1725,29,26,6,3,2,3,5,2,4,"High",3,3
"2746",17,109,0,0.71452,27,8,2,5,4,2,6,2,4,"High",-3,3
"2747",17,110,1,1.052,58,60,10,5,0,1,1,0,4,"Low",5,5
"2748",17,111,1,1.1939,13,26,5,3,1,4,5,1,4,"High",2,2
"2749",17,112,0,1.1927,70,44,9,4,2,0,2,0,4,"Low",5,5
"2750",17,113,1,0.74328,82,18,10,6,2,4,6,2,4,"High",4,4
"2751",17,114,0,0.88797,115,39,3,8,4,4,8,4,4,"High",-5,5
"2752",17,115,1,0.86681,140,68,10,9,0,4,4,0,4,"Low",1,1
"2753",17,116,1,0.82398,120,56,3,3,4,1,5,4,4,"High",0,0
"2754",17,117,0,0.60286,30,12,10,10,4,2,6,2,4,"High",0,0
"2755",17,118,1,1.1316,13,130,5,1,2,1,3,2,4,"Low",4,4
"2756",17,119,1,0.95611,110,54,1,3,2,2,4,2,4,"Low",-2,2
"2757",17,120,1,1.4395,72,38,2,7,3,4,7,3,4,"High",-5,5
"2758",17,121,1,1.1622,10,97,6,4,4,2,6,4,4,"High",2,2
"2759",17,122,1,0.68238,139,78,10,8,2,4,6,2,4,"High",2,2
"2760",17,123,1,0.87102,48,114,7,4,4,4,8,4,4,"High",3,3
"2761",17,124,0,1.1703,128,44,4,4,2,1,3,1,4,"Low",0,0
"2762",17,125,0,0.91988,91,44,8,4,1,2,3,2,4,"Low",4,4
"2763",17,126,1,0.96174,132,13,6,5,2,3,5,2,4,"High",1,1
"2764",17,127,1,0.92174,8,2,5,4,3,1,4,3,4,"Low",1,1
"2765",17,128,0,2.3272,72,44,2,4,4,3,7,3,4,"High",-2,2
"2766",17,129,1,2.0567,44,41,4,7,4,4,8,4,4,"High",-3,3
"2767",17,130,0,1.0494,144,91,5,8,3,2,5,2,4,"High",-3,3
"2768",17,131,1,1.2859,55,54,4,3,4,3,7,4,4,"High",1,1
"2769",17,132,1,1.3128,6,106,10,5,0,1,1,0,4,"Low",5,5
"2770",17,133,0,1.3467,20,2,4,4,1,2,3,2,4,"Low",0,0
"2771",17,134,1,2.2121,62,127,8,3,0,2,2,0,4,"Low",5,5
"2772",17,135,0,1.2583,53,21,1,5,2,4,6,4,4,"High",-4,4
"2773",17,136,0,1.1322,37,66,6,7,1,3,4,3,4,"Low",-1,1
"2774",17,137,1,0.86106,74,43,3,3,0,2,2,0,4,"Low",0,0
"2775",17,138,1,1.4896,9,29,4,6,3,3,6,3,4,"High",-2,2
"2776",17,139,1,1.1341,3,34,10,7,3,3,6,3,4,"High",3,3
"2777",17,140,0,0.93984,37,13,6,5,2,4,6,4,4,"High",1,1
"2778",17,141,1,1.1885,29,54,6,3,4,4,8,4,4,"High",3,3
"2779",17,142,0,1.1618,62,1,8,6,1,4,5,4,4,"High",2,2
"2780",17,143,0,1.2899,71,131,8,8,3,3,6,3,4,"High",0,0
"2781",17,144,1,2.4426,5,57,10,6,2,3,5,2,4,"High",4,4
"2782",17,145,1,1.4705,2,50,4,2,3,0,3,3,4,"Low",2,2
"2783",17,146,0,1.1247,51,31,3,4,1,2,3,2,4,"Low",-1,1
"2784",17,147,1,0.85402,145,86,9,10,2,0,2,2,4,"Low",-1,1
"2785",17,148,1,1.3669,143,17,8,8,2,2,4,2,4,"Low",0,0
"2786",17,149,0,1.4061,97,62,4,8,3,2,5,2,4,"High",-4,4
"2787",17,150,0,1.0602,34,90,7,9,4,1,5,1,4,"High",-2,2
"2788",17,151,1,0.99024,17,127,8,3,3,3,6,3,4,"High",5,5
"2789",17,152,1,0.97388,28,50,1,2,1,1,2,1,4,"Low",-1,1
"2790",17,153,0,0.59097,12,58,10,10,3,1,4,1,4,"Low",0,0
"2791",17,154,1,0.85358,91,35,8,7,3,2,5,3,4,"High",1,1
"2792",17,155,0,0.85921,50,66,2,7,2,4,6,4,4,"High",-5,5
"2793",17,156,0,2.4551,53,147,1,1,3,1,4,1,4,"Low",0,0
"2794",17,157,0,1.3793,147,2,1,4,2,4,6,4,4,"High",-3,3
"2795",17,158,1,0.88055,43,97,3,4,3,4,7,3,4,"High",-1,1
"2796",17,159,1,1.3807,71,20,8,4,4,2,6,4,4,"High",4,4
"2797",17,160,0,1.9368,51,20,3,4,2,3,5,3,4,"High",-1,1
"2798",17,161,1,0.94463,86,17,10,8,1,4,5,1,4,"High",2,2
"2799",17,162,0,1.272,74,67,3,5,1,2,3,2,4,"Low",-2,2
"2800",17,163,0,1.1566,91,145,8,9,4,3,7,3,4,"High",-1,1
"2801",17,164,0,1.6049,51,128,3,4,3,3,6,3,4,"High",-1,1
"2802",17,165,1,1.0907,4,42,2,1,2,1,3,2,4,"Low",1,1
"2803",17,166,0,1.9254,56,62,3,8,2,3,5,3,4,"High",-5,5
"2804",17,167,0,2.326,112,16,2,1,3,4,7,4,4,"High",1,1
"2805",17,168,0,0.88217,132,12,6,10,3,4,7,4,4,"High",-4,4
"2806",17,169,0,0.79684,31,8,4,5,3,4,7,4,4,"High",-1,1
"2807",17,170,1,1.0349,127,74,3,3,4,2,6,4,4,"High",0,0
"2808",17,171,0,1.6477,107,106,1,5,0,2,2,2,4,"Low",-4,4
"2809",17,172,1,1.0911,57,110,6,1,4,3,7,4,4,"High",5,5
"2810",17,173,0,1.0555,74,67,3,5,3,3,6,3,4,"High",-2,2
"2811",17,174,1,1.4919,143,106,8,5,3,3,6,3,4,"High",3,3
"2812",17,175,0,3.2246,110,53,1,1,4,4,8,4,4,"High",0,0
"2813",17,176,0,1.4759,51,128,3,4,4,4,8,4,4,"High",-1,1
"2814",17,177,1,1.4014,28,74,1,3,2,4,6,2,4,"High",-2,2
"2815",17,178,1,0.74776,90,7,9,8,2,4,6,2,4,"High",1,1
"2816",17,179,0,0.77272,122,58,5,10,2,2,4,2,4,"Low",-5,5
"2817",17,180,1,1.0237,43,112,3,2,4,4,8,4,4,"High",1,1
"2818",17,181,1,1.0289,143,106,8,5,4,4,8,4,4,"High",3,3
"2819",17,182,1,0.96996,122,31,5,4,3,4,7,3,4,"High",1,1
"2820",17,183,0,1.0554,58,145,10,9,3,4,7,4,4,"High",1,1
"2821",17,184,1,2.0773,132,4,6,2,4,3,7,4,4,"High",4,4
"2822",17,185,1,0.8342,119,131,10,8,1,4,5,1,4,"High",2,2
"2823",17,186,0,0.90499,62,119,8,10,4,2,6,2,4,"High",-2,2
"2824",17,187,1,1.9734,37,130,6,1,3,2,5,3,4,"High",5,5
"2825",17,188,1,1.1165,67,56,5,3,4,3,7,4,4,"High",2,2
"2826",17,189,0,1.1531,50,42,2,1,3,2,5,2,4,"High",1,1
"2827",17,190,0,1.4036,107,37,1,6,1,4,5,4,4,"High",-5,5
"2828",17,191,1,1.2337,139,58,10,10,3,4,7,3,4,"High",0,0
"2829",17,192,1,1.095,77,60,9,5,2,2,4,2,4,"Low",4,4
"2830",17,193,0,1.8017,60,3,5,10,3,4,7,4,4,"High",-5,5
"2831",17,194,0,1.1197,107,42,1,1,2,3,5,3,4,"High",0,0
"2832",17,195,0,1.2651,147,146,1,3,3,1,4,1,4,"Low",-2,2
"2833",17,196,1,1.2026,86,6,10,10,2,1,3,2,4,"Low",0,0
"2834",17,197,0,1.1733,20,42,4,1,4,4,8,4,4,"High",3,3
"2835",17,198,0,2.6631,9,144,4,5,4,4,8,4,4,"High",-1,1
"2836",17,199,1,0.94726,147,130,1,1,4,3,7,4,4,"High",0,0
"2837",17,200,0,1.1769,60,35,5,7,4,3,7,3,4,"High",-2,2
"2838",18,1,1,1.7954,78,119,4,4,0,0,0,0,4,"Low",0,0
"2839",18,2,0,1.7133,108,131,4,3,0,0,0,0,4,"Low",1,1
"2840",18,3,1,1.5226,70,134,1,5,0,0,0,0,4,"Low",-4,4
"2841",18,4,1,1.5028,131,119,3,4,1,1,2,1,4,"Low",-1,1
"2842",18,5,1,1.5767,24,82,5,6,0,0,0,0,4,"Low",-1,1
"2843",18,6,0,2.8207,71,80,3,6,0,0,0,0,4,"Low",-3,3
"2844",18,7,1,1.5441,88,146,7,7,0,0,0,0,4,"Low",0,0
"2845",18,8,0,2.8502,16,40,2,1,0,0,0,0,4,"Low",1,1
"2846",18,9,1,5.309,5,107,4,5,0,0,0,0,4,"Low",-1,1
"2847",18,10,0,1.6031,139,61,5,6,0,0,0,0,4,"Low",-1,1
"2848",18,11,0,2.521,91,119,5,4,0,2,2,2,4,"Low",1,1
"2849",18,12,1,3.609,128,28,7,5,0,0,0,0,4,"Low",2,2
"2850",18,13,1,5.9545,101,52,2,1,0,0,0,0,4,"Low",1,1
"2851",18,14,1,2.2495,66,42,1,3,0,0,0,0,4,"Low",-2,2
"2852",18,15,1,5.0013,139,45,5,4,1,0,1,1,4,"Low",1,1
"2853",18,16,1,5.0116,139,28,5,5,2,1,3,2,4,"Low",0,0
"2854",18,17,1,1.4991,141,143,7,4,0,0,0,0,4,"Low",3,3
"2855",18,18,0,6.8611,50,28,3,5,0,2,2,2,4,"Low",-2,2
"2856",18,19,0,1.2108,91,88,5,7,1,1,2,1,4,"Low",-2,2
"2857",18,20,1,3.7011,78,70,4,1,1,1,2,1,4,"Low",3,3
"2858",18,21,1,1.4879,11,91,4,5,0,2,2,0,4,"Low",-1,1
"2859",18,22,1,4.1873,4,45,4,4,0,1,1,0,4,"Low",0,0
"2860",18,23,0,1.3578,110,56,7,10,0,0,0,0,4,"Low",-3,3
"2861",18,24,1,3.1275,70,50,1,3,2,1,3,2,4,"Low",-2,2
"2862",18,25,1,1.3268,146,133,7,4,1,0,1,1,4,"Low",3,3
"2863",18,26,1,1.8534,4,107,4,5,1,1,2,1,4,"Low",-1,1
"2864",18,27,0,3.3175,85,24,3,5,0,1,1,1,4,"Low",-2,2
"2865",18,28,1,3.981,43,131,5,3,0,2,2,0,4,"Low",2,2
"2866",18,29,0,1.9375,99,97,3,3,0,0,0,0,4,"Low",0,0
"2867",18,30,0,1.651,70,80,1,6,3,1,4,1,4,"Low",-5,5
"2868",18,31,1,1.0803,141,7,7,6,1,0,1,1,4,"Low",1,1
"2869",18,32,1,3.2284,73,12,5,6,0,0,0,0,4,"Low",-1,1
"2870",18,33,1,5.2972,130,100,5,7,0,0,0,0,4,"Low",-2,2
"2871",18,34,1,1.5446,14,19,3,5,0,0,0,0,4,"Low",-2,2
"2872",18,35,0,1.5092,42,14,3,3,1,1,2,1,4,"Low",0,0
"2873",18,36,0,1.437,16,19,2,5,1,1,2,1,4,"Low",-3,3
"2874",18,37,0,4.9098,73,79,5,8,1,0,1,0,4,"Low",-3,3
"2875",18,38,1,0.93546,126,139,5,5,0,3,3,0,4,"Low",0,0
"2876",18,39,0,0.94992,45,61,4,6,2,1,3,1,4,"Low",-2,2
"2877",18,40,0,0.91881,50,73,3,5,2,2,4,2,4,"Low",-2,2
"2878",18,41,1,2.2262,80,13,6,2,2,0,2,2,4,"Low",4,4
"2879",18,42,0,1.5368,133,33,4,7,1,0,1,0,4,"Low",-3,3
"2880",18,43,0,10.7135,98,135,3,2,0,0,0,0,4,"Low",1,1
"2881",18,44,1,1.0164,56,3,10,8,1,0,1,1,4,"Low",2,2
"2882",18,45,0,1.8832,108,77,4,4,1,0,1,0,4,"Low",0,0
"2883",18,46,1,1.5932,78,2,4,5,2,0,2,2,4,"Low",-1,1
"2884",18,47,0,3.1144,35,14,3,3,0,2,2,2,4,"Low",0,0
"2885",18,48,0,6.7119,91,107,5,5,3,2,5,2,4,"High",0,0
"2886",18,49,0,1.1152,27,131,4,3,0,3,3,3,4,"Low",1,1
"2887",18,50,1,1.6365,10,27,9,4,0,1,1,0,4,"Low",5,5
"2888",18,51,0,1.4495,50,106,3,5,3,0,3,0,4,"Low",-2,2
"2889",18,52,1,5.8736,89,134,3,5,0,1,1,0,4,"Low",-2,2
"2890",18,53,1,0.99503,61,131,6,3,2,4,6,2,4,"High",3,3
"2891",18,54,0,2.5164,128,41,7,9,1,0,1,0,4,"Low",-2,2
"2892",18,55,0,1.6216,119,145,4,6,3,0,3,0,4,"Low",-2,2
"2893",18,56,0,2.0851,45,73,4,5,3,3,6,3,4,"High",-1,1
"2894",18,57,0,1.6611,108,147,4,5,2,0,2,0,4,"Low",-1,1
"2895",18,58,0,2.0858,52,8,1,6,1,0,1,0,4,"Low",-5,5
"2896",18,59,0,2.1701,27,134,4,5,2,2,4,2,4,"Low",-1,1
"2897",18,60,0,2.5799,50,130,3,5,4,1,5,1,4,"High",-2,2
"2898",18,61,1,1.2013,126,102,5,3,1,0,1,1,4,"Low",2,2
"2899",18,62,1,1.3546,14,75,3,5,3,0,3,3,4,"Low",-2,2
"2900",18,63,1,1.2854,130,98,5,3,2,1,3,2,4,"Low",2,2
"2901",18,64,1,1.3189,61,46,6,2,3,0,3,3,4,"Low",4,4
"2902",18,65,1,3.6429,86,2,1,5,0,1,1,0,4,"Low",-4,4
"2903",18,66,0,1.8374,31,24,2,5,0,2,2,2,4,"Low",-3,3
"2904",18,67,0,1.1541,7,73,6,5,1,4,5,4,4,"High",1,1
"2905",18,68,1,1.5922,130,98,5,3,3,2,5,3,4,"High",2,2
"2906",18,69,0,4.452,63,46,2,2,0,1,1,1,4,"Low",0,0
"2907",18,70,1,1.6731,85,119,3,4,1,4,5,1,4,"High",-1,1
"2908",18,71,0,2.3605,31,101,2,2,1,1,2,1,4,"Low",0,0
"2909",18,72,1,1.0052,87,91,10,5,0,4,4,0,4,"Low",5,5
"2910",18,73,0,2.1426,96,19,4,5,0,2,2,2,4,"Low",-1,1
"2911",18,74,1,4.3361,134,31,5,2,3,2,5,3,4,"High",3,3
"2912",18,75,0,3.9379,77,53,4,9,1,0,1,0,4,"Low",-5,5
"2913",18,76,1,1.178,61,96,6,4,4,1,5,4,4,"High",2,2
"2914",18,77,1,1.8816,77,101,4,2,2,2,4,2,4,"Low",2,2
"2915",18,78,0,1.5887,5,28,4,5,1,3,4,3,4,"Low",-1,1
"2916",18,79,0,3.833,90,139,8,5,0,4,4,4,4,"Low",3,3
"2917",18,80,0,1.3508,45,44,4,5,4,0,4,0,4,"Low",-1,1
"2918",18,81,1,2.1184,82,108,6,4,1,3,4,1,4,"Low",2,2
"2919",18,82,1,2.5797,56,3,10,8,2,1,3,2,4,"Low",2,2
"2920",18,83,1,2.2856,77,71,4,3,3,1,4,3,4,"Low",1,1
"2921",18,84,1,0.98846,10,138,9,10,1,0,1,1,4,"Low",-1,1
"2922",18,85,0,0.82779,101,108,2,4,3,4,7,4,4,"High",-2,2
"2923",18,86,0,1.3934,126,145,5,6,2,1,3,1,4,"Low",-1,1
"2924",18,87,0,2.0166,89,71,3,3,1,2,3,2,4,"Low",0,0
"2925",18,88,1,1.1321,101,114,2,2,4,0,4,4,4,"Low",0,0
"2926",18,89,0,2.0395,28,94,5,6,4,0,4,0,4,"Low",-1,1
"2927",18,90,0,5.7781,98,107,3,5,3,3,6,3,4,"High",-2,2
"2928",18,91,1,1.4489,85,78,3,4,2,3,5,2,4,"High",-1,1
"2929",18,92,1,2.3556,53,79,9,8,1,1,2,1,4,"Low",1,1
"2930",18,93,1,1.1356,143,42,4,3,1,2,3,1,4,"Low",1,1
"2931",18,94,0,1.9077,146,44,7,5,2,1,3,1,4,"Low",2,2
"2932",18,95,1,1.3182,128,98,7,3,2,4,6,2,4,"High",4,4
"2933",18,96,1,4.7262,133,100,4,7,2,1,3,2,4,"Low",-3,3
"2934",18,97,1,7.5517,16,65,2,2,2,0,2,2,4,"Low",0,0
"2935",18,98,0,1.4785,60,79,8,8,0,2,2,2,4,"Low",0,0
"2936",18,99,1,1.2664,10,4,9,4,2,2,4,2,4,"Low",5,5
"2937",18,100,1,1.7978,4,134,4,5,3,4,7,3,4,"High",-1,1
"2938",18,101,0,1.2853,58,94,10,6,0,1,1,1,4,"Low",4,4
"2939",18,102,1,1.2507,146,42,7,3,3,3,6,3,4,"High",4,4
"2940",18,103,0,1.9854,65,114,2,2,1,1,2,1,4,"Low",0,0
"2941",18,104,0,0.97144,2,92,5,9,2,0,2,0,4,"Low",-4,4
"2942",18,105,0,1.6895,31,110,2,7,3,1,4,1,4,"Low",-5,5
"2943",18,106,0,1.114,65,126,2,5,2,3,5,3,4,"High",-3,3
"2944",18,107,0,1.151,52,19,1,5,2,3,5,3,4,"High",-4,4
"2945",18,108,1,1.2613,43,143,5,4,1,2,3,1,4,"Low",1,1
"2946",18,109,1,1.8663,2,89,5,3,3,2,5,3,4,"High",2,2
"2947",18,110,1,1.5122,3,100,8,7,2,2,4,2,4,"Low",1,1
"2948",18,111,0,1.4477,75,128,5,7,1,3,4,3,4,"Low",-2,2
"2949",18,112,0,1.815,130,126,5,5,4,4,8,4,4,"High",0,0
"2950",18,113,1,1.4644,11,110,4,7,1,2,3,1,4,"Low",-3,3
"2951",18,114,0,0.92448,120,87,10,10,0,1,1,1,4,"Low",0,0
"2952",18,115,1,0.79662,147,75,5,5,1,2,3,1,4,"Low",0,0
"2953",18,116,0,0.79782,42,13,3,2,4,1,5,1,4,"High",1,1
"2954",18,117,0,4.9119,107,43,5,5,4,2,6,2,4,"High",0,0
"2955",18,118,1,1.0341,56,41,10,9,3,1,4,3,4,"Low",1,1
"2956",18,119,0,2.7012,3,11,8,4,3,2,5,2,4,"High",4,4
"2957",18,120,0,0.91876,80,79,6,8,3,3,6,3,4,"High",-2,2
"2958",18,121,1,0.70799,56,75,10,5,4,3,7,4,4,"High",5,5
"2959",18,122,0,1.1453,133,12,4,6,3,1,4,1,4,"Low",-2,2
"2960",18,123,1,1.5021,138,7,10,6,1,2,3,1,4,"Low",4,4
"2961",18,124,0,1.3576,7,120,6,10,3,1,4,1,4,"Low",-4,4
"2962",18,125,0,0.9351,94,92,6,9,2,1,3,1,4,"Low",-3,3
"2963",18,126,1,1.9638,88,11,7,4,2,3,5,2,4,"High",3,3
"2964",18,127,1,2.363,146,41,7,9,4,2,6,4,4,"High",-2,2
"2965",18,128,0,1.6984,86,70,1,1,1,4,5,4,4,"High",0,0
"2966",18,129,1,2.0404,19,6,5,4,4,0,4,4,4,"Low",1,1
"2967",18,130,1,1.2224,94,86,6,1,3,2,5,3,4,"High",5,5
"2968",18,131,0,1.4064,60,44,8,5,1,2,3,2,4,"Low",3,3
"2969",18,132,1,1.0114,95,138,5,10,0,2,2,0,4,"Low",-5,5
"2970",18,133,1,2.3545,80,46,6,2,4,2,6,4,4,"High",4,4
"2971",18,134,0,1.1725,71,94,3,6,3,4,7,4,4,"High",-3,3
"2972",18,135,0,1.5822,100,18,7,10,3,0,3,0,4,"Low",-3,3
"2973",18,136,1,1.54,43,6,5,4,3,1,4,3,4,"Low",1,1
"2974",18,137,1,6.9047,78,135,4,2,4,1,5,4,4,"High",2,2
"2975",18,138,1,2.0901,79,11,8,4,4,4,8,4,4,"High",4,4
"2976",18,139,1,0.95819,110,63,7,2,3,1,4,3,4,"Low",5,5
"2977",18,140,1,1.3577,97,96,3,4,1,2,3,1,4,"Low",-1,1
"2978",18,141,1,2.1502,106,46,5,2,1,3,4,1,4,"Low",3,3
"2979",18,142,0,1.5975,75,8,5,6,4,1,5,1,4,"High",-1,1
"2980",18,143,1,1.4444,43,71,5,3,4,4,8,4,4,"High",2,2
"2981",18,144,1,0.98764,110,65,7,2,4,3,7,4,4,"High",5,5
"2982",18,145,0,2.4146,7,60,6,8,4,2,6,2,4,"High",-2,2
"2983",18,146,0,2.064,96,95,4,5,3,1,4,1,4,"Low",-1,1
"2984",18,147,1,1.2958,68,96,5,4,0,4,4,0,4,"Low",1,1
"2985",18,148,1,2.1259,13,143,2,4,2,3,5,2,4,"High",-2,2
"2986",18,149,1,1.1312,8,102,6,3,2,1,3,2,4,"Low",3,3
"2987",18,150,0,1.0393,97,3,3,8,2,4,6,4,4,"High",-5,5
"2988",18,151,0,2.4387,53,95,9,5,2,2,4,2,4,"Low",4,4
"2989",18,152,0,1.5082,114,13,2,2,2,3,5,3,4,"High",0,0
"2990",18,153,0,3.0649,89,133,3,4,3,4,7,4,4,"High",-1,1
"2991",18,154,1,2.137,120,53,10,9,2,3,5,2,4,"High",1,1
"2992",18,155,0,2.2503,8,13,6,2,3,4,7,4,4,"High",4,4
"2993",18,156,1,3.4835,14,143,3,4,4,4,8,4,4,"High",-1,1
"2994",18,157,1,1.8945,44,120,5,10,3,3,6,3,4,"High",-5,5
"2995",18,158,1,2.2927,68,124,5,4,1,0,1,1,4,"Low",1,1
"2996",18,159,0,2.3353,60,24,8,5,3,3,6,3,4,"High",3,3
"2997",18,160,0,6.718,124,52,4,1,1,3,4,3,4,"Low",3,3
"2998",18,161,1,1.5426,58,41,10,9,1,3,4,1,4,"Low",1,1
"2999",18,162,0,1.3888,99,24,3,5,1,4,5,4,4,"High",-2,2
"3000",18,163,0,1.1249,120,145,10,6,4,2,6,2,4,"High",4,4
"3001",18,164,1,1.0502,25,2,7,5,0,4,4,0,4,"Low",2,2
"3002",18,165,0,2.2922,60,44,8,5,4,4,8,4,4,"High",3,3
"3003",18,166,1,4.1888,5,52,4,1,2,4,6,2,4,"High",3,3
"3004",18,167,0,2.6583,31,114,2,2,4,3,7,3,4,"High",0,0
"3005",18,168,0,0.98781,90,25,8,7,1,1,2,1,4,"Low",1,1
"3006",18,169,0,0.94841,63,85,2,3,2,3,5,3,4,"High",-1,1
"3007",18,170,0,2.7865,97,135,3,2,3,2,5,2,4,"High",1,1
"3008",18,171,1,3.5939,82,4,6,4,2,4,6,2,4,"High",2,2
"3009",18,172,1,6.951,97,5,3,4,4,3,7,4,4,"High",-1,1
"3010",18,173,0,2.5213,5,6,4,4,4,2,6,2,4,"High",0,0
"3011",18,174,1,1.2828,25,138,7,10,2,3,5,2,4,"High",-3,3
"3012",18,175,1,1.5629,82,40,6,1,3,1,4,3,4,"Low",5,5
"3013",18,176,0,1.0427,124,99,4,3,2,2,4,2,4,"Low",1,1
"3014",18,177,1,1.6497,68,16,5,2,2,3,5,2,4,"High",3,3
"3015",18,178,0,1.5022,102,46,3,2,2,4,6,4,4,"High",1,1
"3016",18,179,1,0.96514,25,102,7,3,3,3,6,3,4,"High",4,4
"3017",18,180,0,0.75052,114,12,2,6,4,2,6,2,4,"High",-4,4
"3018",18,181,1,1.0311,88,35,7,3,3,1,4,3,4,"Low",4,4
"3019",18,182,0,3.1738,128,68,7,5,4,3,7,3,4,"High",2,2
"3020",18,183,1,1.4366,135,102,2,3,3,4,7,3,4,"High",-1,1
"3021",18,184,1,2.3772,53,12,9,6,4,3,7,4,4,"High",3,3
"3022",18,185,1,1.9638,8,35,6,3,4,2,6,4,4,"High",3,3
"3023",18,186,1,2.9839,106,25,5,7,2,4,6,2,4,"High",-2,2
"3024",18,187,1,1.9188,147,6,5,4,2,3,5,2,4,"High",1,1
"3025",18,188,1,3.0733,135,63,2,2,4,3,7,4,4,"High",0,0
"3026",18,189,1,2.0415,145,124,6,4,3,3,6,3,4,"High",2,2
"3027",18,190,1,2.6889,27,66,4,1,3,1,4,3,4,"Low",3,3
"3028",18,191,0,2.0488,41,145,9,6,4,4,8,4,4,"High",3,3
"3029",18,192,0,2.093,89,16,3,2,4,4,8,4,4,"High",1,1
"3030",18,193,1,1.9709,68,100,5,7,4,4,8,4,4,"High",-2,2
"3031",18,194,1,2.5718,141,92,7,9,2,2,4,2,4,"Low",-2,2
"3032",18,195,1,1.5692,85,124,3,4,4,4,8,4,4,"High",-1,1
"3033",18,196,0,1.6119,33,92,7,9,1,3,4,3,4,"Low",-2,2
"3034",18,197,0,3.5438,66,6,1,4,2,4,6,4,4,"High",-3,3
"3035",18,198,0,2.0658,18,147,10,5,1,3,4,3,4,"Low",5,5
"3036",18,199,1,1.9524,10,138,9,10,3,4,7,3,4,"High",-1,1
"3037",18,200,0,2.3102,58,95,10,5,2,3,5,3,4,"High",5,5
"3038",19,1,0,1.0724,100,39,5,3,0,0,0,0,4,"Low",2,2
"3039",19,2,1,1.1323,65,6,5,2,0,0,0,0,4,"Low",3,3
"3040",19,3,1,1.3156,25,4,3,1,0,0,0,0,4,"Low",2,2
"3041",19,4,1,1.9495,142,115,1,2,0,0,0,0,4,"Low",-1,1
"3042",19,5,1,1.0377,29,96,8,3,0,0,0,0,4,"Low",5,5
"3043",19,6,0,0.60915,31,41,2,6,0,0,0,0,4,"Low",-4,4
"3044",19,7,1,1.1036,141,18,2,2,0,0,0,0,4,"Low",0,0
"3045",19,8,1,1.8131,24,115,3,2,0,1,1,0,4,"Low",1,1
"3046",19,9,1,1.2812,120,100,4,5,0,1,1,0,4,"Low",-1,1
"3047",19,10,0,0.76647,86,89,2,6,0,0,0,0,4,"Low",-4,4
"3048",19,11,1,1.1678,35,120,4,4,0,1,1,0,4,"Low",0,0
"3049",19,12,0,1.2654,130,83,1,3,0,0,0,0,4,"Low",-2,2
"3050",19,13,1,7.7945,34,46,7,5,0,0,0,0,4,"Low",2,2
"3051",19,14,0,0.83328,115,123,2,2,2,0,2,0,4,"Low",0,0
"3052",19,15,1,1.4362,147,120,1,4,0,2,2,0,4,"Low",-3,3
"3053",19,16,0,1.2214,31,106,2,2,1,0,1,0,4,"Low",0,0
"3054",19,17,0,0.6755,32,34,2,7,0,1,1,1,4,"Low",-5,5
"3055",19,18,0,1.1259,25,89,3,6,1,1,2,1,4,"Low",-3,3
"3056",19,19,0,1.3741,115,65,2,5,3,1,4,1,4,"Low",-3,3
"3057",19,20,1,1.165,78,147,1,1,0,1,1,0,4,"Low",0,0
"3058",19,21,0,0.6938,53,58,1,5,0,0,0,0,4,"Low",-4,4
"3059",19,22,1,0.62957,89,122,6,4,2,0,2,2,4,"Low",2,2
"3060",19,23,1,1.1466,35,82,4,1,1,0,1,1,4,"Low",3,3
"3061",19,24,0,2.5993,60,4,1,1,0,1,1,1,4,"Low",0,0
"3062",19,25,0,1.0459,4,123,1,2,2,1,3,1,4,"Low",-1,1
"3063",19,26,1,2.0901,128,86,1,2,0,1,1,0,4,"Low",-1,1
"3064",19,27,0,0.62184,37,65,2,5,0,2,2,2,4,"Low",-3,3
"3065",19,28,0,0.94835,127,133,2,4,0,0,0,0,4,"Low",-2,2
"3066",19,29,0,0.59523,16,89,3,6,0,3,3,3,4,"Low",-3,3
"3067",19,30,1,1.3473,141,18,2,2,1,1,2,1,4,"Low",0,0
"3068",19,31,1,0.63483,101,120,9,4,0,3,3,0,4,"Low",5,5
"3069",19,32,1,2.222,44,76,2,3,0,0,0,0,4,"Low",-1,1
"3070",19,33,1,1.9687,83,136,3,1,1,0,1,1,4,"Low",2,2
"3071",19,34,0,1.6641,122,85,4,7,1,0,1,0,4,"Low",-3,3
"3072",19,35,0,5.0597,128,53,1,1,1,1,2,1,4,"Low",0,0
"3073",19,36,0,2.1922,60,38,1,2,1,0,1,0,4,"Low",-1,1
"3074",19,37,0,1.0778,115,35,2,4,4,2,6,2,4,"High",-2,2
"3075",19,38,0,2.1984,65,45,5,6,3,0,3,0,4,"Low",-1,1
"3076",19,39,0,0.7343,86,83,2,3,2,2,4,2,4,"Low",-1,1
"3077",19,40,1,0.65527,129,78,6,1,0,1,1,0,4,"Low",5,5
"3078",19,41,0,0.71807,66,45,5,6,0,1,1,1,4,"Low",-1,1
"3079",19,42,0,1.1247,82,48,1,4,1,0,1,0,4,"Low",-3,3
"3080",19,43,1,3.6934,16,141,3,2,1,2,3,1,4,"Low",1,1
"3081",19,44,1,1.3693,77,127,2,2,0,1,1,0,4,"Low",0,0
"3082",19,45,0,1.3872,53,123,1,2,2,2,4,2,4,"Low",-1,1
"3083",19,46,0,0.586,23,35,2,4,0,3,3,3,4,"Low",-2,2
"3084",19,47,1,4.3839,6,5,2,2,1,0,1,1,4,"Low",0,0
"3085",19,48,0,3.267,136,6,1,2,1,2,3,2,4,"Low",-1,1
"3086",19,49,0,1.9743,31,42,2,3,2,0,2,0,4,"Low",-1,1
"3087",19,50,0,0.96563,17,122,2,4,0,2,2,2,4,"Low",-2,2
"3088",19,51,1,1.6378,113,3,4,1,0,0,0,0,4,"Low",3,3
"3089",19,52,1,4.1049,84,112,3,4,0,0,0,0,4,"Low",-1,1
"3090",19,53,1,0.8179,65,122,5,4,4,3,7,4,4,"High",1,1
"3091",19,54,1,0.63032,35,8,4,1,4,0,4,4,4,"Low",3,3
"3092",19,55,1,1.0192,78,18,1,2,2,2,4,2,4,"Low",-1,1
"3093",19,56,1,0.88911,85,38,7,2,1,1,2,1,4,"Low",5,5
"3094",19,57,1,1.467,16,4,3,1,2,3,5,2,4,"High",2,2
"3095",19,58,1,0.55765,85,32,7,2,2,1,3,2,4,"Low",5,5
"3096",19,59,1,2.9078,127,31,2,2,2,3,5,2,4,"High",0,0
"3097",19,60,0,1.3019,123,84,2,3,3,1,4,1,4,"Low",-1,1
"3098",19,61,0,1.8486,128,37,1,2,2,1,3,1,4,"Low",-1,1
"3099",19,62,1,1.0286,58,60,5,1,1,2,3,1,4,"Low",4,4
"3100",19,63,1,1.354,79,100,1,5,0,2,2,0,4,"Low",-4,4
"3101",19,64,0,1.3214,4,90,1,2,4,0,4,0,4,"Low",-1,1
"3102",19,65,0,1.2116,96,16,3,3,1,3,4,3,4,"Low",0,0
"3103",19,66,0,1.0441,32,133,2,4,2,1,3,1,4,"Low",-2,2
"3104",19,67,0,0.94971,24,129,3,6,1,1,2,1,4,"Low",-3,3
"3105",19,68,1,1.4608,48,121,4,3,1,0,1,1,4,"Low",1,1
"3106",19,69,0,1.4575,16,112,3,4,4,1,5,1,4,"High",-1,1
"3107",19,70,0,1.1443,130,76,1,3,1,1,2,1,4,"Low",-2,2
"3108",19,71,1,1.2324,6,27,2,1,3,0,3,3,4,"Low",1,1
"3109",19,72,0,0.82159,6,89,2,6,4,4,8,4,4,"High",-4,4
"3110",19,73,1,1.1023,58,108,5,2,2,0,2,2,4,"Low",3,3
"3111",19,74,1,1.8697,101,66,9,5,1,1,2,1,4,"Low",4,4
"3112",19,75,0,0.84944,130,58,1,5,2,3,5,3,4,"High",-4,4
"3113",19,76,1,0.63736,25,5,3,2,2,1,3,2,4,"Low",1,1
"3114",19,77,1,0.80188,49,39,7,3,0,1,1,0,4,"Low",4,4
"3115",19,78,0,1.0467,130,120,1,4,3,4,7,4,4,"High",-3,3
"3116",19,79,1,0.83123,78,134,1,1,3,0,3,3,4,"Low",0,0
"3117",19,80,1,2.7301,90,107,2,1,1,0,1,1,4,"Low",1,1
"3118",19,81,0,0.67351,32,123,2,2,3,4,7,4,4,"High",0,0
"3119",19,82,1,0.70751,5,24,2,3,2,2,4,2,4,"Low",-1,1
"3120",19,83,0,1.0935,119,48,3,4,0,2,2,2,4,"Low",-1,1
"3121",19,84,0,0.67992,23,84,2,3,1,2,3,2,4,"Low",-1,1
"3122",19,85,1,2.7142,48,77,4,2,3,1,4,3,4,"Low",2,2
"3123",19,86,1,2.1943,96,5,3,2,2,3,5,2,4,"High",1,1
"3124",19,87,0,1.145,96,78,3,1,3,4,7,4,4,"High",2,2
"3125",19,88,0,3.0776,17,23,2,2,1,2,3,2,4,"Low",0,0
"3126",19,89,0,1.5863,143,127,2,2,0,3,3,3,4,"Low",0,0
"3127",19,90,0,1.1777,17,31,2,2,2,4,6,4,4,"High",0,0
"3128",19,91,0,1.801,88,83,1,3,0,3,3,3,4,"Low",-2,2
"3129",19,92,1,1.3838,77,127,2,2,2,4,6,2,4,"High",0,0
"3130",19,93,0,0.84645,17,76,2,3,3,2,5,2,4,"High",-1,1
"3131",19,94,1,1.074,48,60,4,1,4,3,7,4,4,"High",3,3
"3132",19,95,1,1.2952,36,37,4,2,0,2,2,0,4,"Low",2,2
"3133",19,96,1,1.2501,107,47,1,1,1,0,1,1,4,"Low",0,0
"3134",19,97,0,0.71991,17,111,2,1,4,0,4,0,4,"Low",1,1
"3135",19,98,1,0.97322,46,90,5,2,1,2,3,1,4,"Low",3,3
"3136",19,99,1,1.6201,24,106,3,2,3,1,4,3,4,"Low",1,1
"3137",19,100,1,1.9146,84,58,3,5,3,4,7,3,4,"High",-2,2
"3138",19,101,1,2.2009,27,32,1,2,1,4,5,1,4,"High",-1,1
"3139",19,102,0,1.2948,128,7,1,2,3,0,3,0,4,"Low",-1,1
"3140",19,103,1,1.475,41,3,6,1,1,1,2,1,4,"Low",5,5
"3141",19,104,1,1.0692,141,143,2,2,3,1,4,3,4,"Low",0,0
"3142",19,105,1,0.75116,111,7,1,2,1,1,2,1,4,"Low",-1,1
"3143",19,106,1,1.0017,34,113,7,4,2,1,3,2,4,"Low",3,3
"3144",19,107,0,1.0963,112,111,4,1,2,2,4,2,4,"Low",3,3
"3145",19,108,1,1.7837,3,8,1,1,2,1,3,2,4,"Low",0,0
"3146",19,109,0,1.4893,43,107,2,1,0,2,2,2,4,"Low",1,1
"3147",19,110,0,1.1264,128,77,1,2,4,3,7,3,4,"High",-1,1
"3148",19,111,1,1.6773,66,86,5,2,2,3,5,2,4,"High",3,3
"3149",19,112,0,1.4091,47,113,1,4,1,2,3,2,4,"Low",-3,3
"3150",19,113,0,0.72068,130,36,1,4,4,1,5,1,4,"High",-3,3
"3151",19,114,0,0.72546,5,84,2,3,4,4,8,4,4,"High",-1,1
"3152",19,115,1,5.5428,34,45,7,6,3,2,5,3,4,"High",1,1
"3153",19,116,0,1.4881,83,50,3,8,4,0,4,0,4,"Low",-5,5
"3154",19,117,1,1.3149,113,82,4,1,3,2,5,3,4,"High",3,3
"3155",19,118,1,0.89733,88,134,1,1,1,1,2,1,4,"Low",0,0
"3156",19,119,1,0.65088,85,119,7,3,3,1,4,3,4,"Low",4,4
"3157",19,120,1,1.0662,49,121,7,3,1,1,2,1,4,"Low",4,4
"3158",19,121,0,1.5422,139,24,1,3,0,4,4,4,4,"Low",-2,2
"3159",19,122,0,2.231,52,107,1,1,0,3,3,3,4,"Low",0,0
"3160",19,123,1,0.86875,49,39,7,3,2,2,4,2,4,"Low",4,4
"3161",19,124,1,0.99111,113,119,4,3,4,2,6,4,4,"High",1,1
"3162",19,125,0,1.1512,121,52,3,1,2,1,3,1,4,"Low",2,2
"3163",19,126,0,0.83119,53,111,1,1,3,3,6,3,4,"High",0,0
"3164",19,127,1,4.684,107,25,1,3,4,3,7,4,4,"High",-2,2
"3165",19,128,0,1.1882,47,129,1,6,2,2,4,2,4,"Low",-5,5
"3166",19,129,1,1.1473,76,27,3,1,3,2,5,3,4,"High",2,2
"3167",19,130,1,1.6514,90,134,2,1,3,2,5,3,4,"High",1,1
"3168",19,131,0,0.90411,119,23,3,2,3,3,6,3,4,"High",1,1
"3169",19,132,0,0.82854,108,34,2,7,1,4,5,4,4,"High",-5,5
"3170",19,133,1,1.1148,91,8,2,1,0,2,2,0,4,"Low",1,1
"3171",19,134,1,1.1342,129,142,6,1,3,1,4,3,4,"Low",5,5
"3172",19,135,0,2.4424,53,44,1,2,4,1,5,1,4,"High",-1,1
"3173",19,136,1,0.78073,45,143,6,2,3,2,5,3,4,"High",4,4
"3174",19,137,0,1.1934,3,39,1,3,3,3,6,3,4,"High",-2,2
"3175",19,138,1,2.8391,79,122,1,4,1,4,5,1,4,"High",-3,3
"3176",19,139,0,0.71584,23,66,2,5,4,3,7,3,4,"High",-3,3
"3177",19,140,1,1.037,7,119,2,3,2,4,6,2,4,"High",-1,1
"3178",19,141,1,1.3458,88,143,1,2,2,3,5,2,4,"High",-1,1
"3179",19,142,1,0.85787,141,27,2,1,4,3,7,4,4,"High",1,1
"3180",19,143,0,1.151,43,41,2,6,1,2,3,2,4,"Low",-4,4
"3181",19,144,0,2.984,108,143,2,2,2,4,6,4,4,"High",0,0
"3182",19,145,0,1.5828,129,91,6,2,4,1,5,1,4,"High",4,4
"3183",19,146,1,4.2074,90,39,2,3,4,4,8,4,4,"High",-1,1
"3184",19,147,1,1.116,52,86,1,2,2,4,6,2,4,"High",-1,1
"3185",19,148,1,1.7486,50,41,8,6,1,3,4,1,4,"Low",2,2
"3186",19,149,0,0.9821,38,41,2,6,2,4,6,4,4,"High",-4,4
"3187",19,150,1,0.87665,25,100,3,5,4,3,7,4,4,"High",-2,2
"3188",19,151,1,0.66906,85,121,7,3,4,3,7,4,4,"High",4,4
"3189",19,152,1,0.84301,36,100,4,5,2,4,6,2,4,"High",-1,1
"3190",19,153,0,1.9668,15,37,3,2,0,3,3,3,4,"Low",1,1
"3191",19,154,1,1.1737,47,139,1,1,3,1,4,3,4,"Low",0,0
"3192",19,155,0,2.5009,77,121,2,3,4,4,8,4,4,"High",-1,1
"3193",19,156,0,1.3522,36,30,4,8,3,0,3,0,4,"Low",-4,4
"3194",19,157,0,2.9778,147,106,1,2,2,2,4,2,4,"Low",-1,1
"3195",19,158,1,0.94004,46,112,5,4,2,3,5,2,4,"High",1,1
"3196",19,159,0,0.68391,136,46,1,5,2,3,5,3,4,"High",-4,4
"3197",19,160,1,0.91072,3,15,1,3,4,1,5,4,4,"High",-2,2
"3198",19,161,0,1.0253,96,29,3,8,4,1,5,1,4,"High",-5,5
"3199",19,162,1,0.81448,133,18,4,2,2,3,5,2,4,"High",2,2
"3200",19,163,1,1.3805,7,139,2,1,3,2,5,3,4,"High",1,1
"3201",19,164,1,0.81721,112,15,4,3,4,2,6,4,4,"High",1,1
"3202",19,165,0,1.8486,8,7,1,2,3,4,7,4,4,"High",-1,1
"3203",19,166,0,0.88212,136,88,1,1,3,3,6,3,4,"High",0,0
"3204",19,167,0,1.2893,15,88,3,1,3,4,7,4,4,"High",2,2
"3205",19,168,1,0.58016,46,18,5,2,4,4,8,4,4,"High",3,3
"3206",19,169,1,0.64353,66,42,5,3,4,1,5,4,4,"High",2,2
"3207",19,170,0,2.8795,147,134,1,1,3,3,6,3,4,"High",0,0
"3208",19,171,0,1.0801,60,79,1,1,4,2,6,2,4,"High",0,0
"3209",19,172,1,1.5884,91,52,2,1,2,3,5,2,4,"High",1,1
"3210",19,173,1,0.70425,45,42,6,3,4,2,6,4,4,"High",3,3
"3211",19,174,0,3.1797,44,79,2,1,2,3,5,3,4,"High",1,1
"3212",19,175,0,1.2105,106,42,2,3,3,3,6,3,4,"High",-1,1
"3213",19,176,1,1.1125,79,27,1,1,4,4,8,4,4,"High",0,0
"3214",19,177,0,0.71378,124,50,8,8,0,2,2,2,4,"Low",0,0
"3215",19,178,1,1.7952,37,38,2,2,4,3,7,4,4,"High",0,0
"3216",19,179,1,1.1279,38,15,2,3,4,4,8,4,4,"High",-1,1
"3217",19,180,0,1.0349,147,76,1,3,4,4,8,4,4,"High",-2,2
"3218",19,181,1,0.86998,52,134,1,1,4,4,8,4,4,"High",0,0
"3219",19,182,0,1.1947,44,91,2,2,3,3,6,3,4,"High",0,0
"3220",19,183,0,1.0907,47,36,1,4,4,4,8,4,4,"High",-3,3
"3221",19,184,1,0.74877,111,91,1,2,4,4,8,4,4,"High",-1,1
"3222",19,185,1,1.2854,42,106,3,2,4,4,8,4,4,"High",1,1
"3223",19,186,0,0.72832,43,133,2,4,2,3,5,3,4,"High",-2,2
"3224",19,187,1,0.7531,50,49,8,7,3,3,6,3,4,"High",1,1
"3225",19,188,1,3.781,136,43,1,2,4,3,7,4,4,"High",-1,1
"3226",19,189,0,1.119,108,139,2,1,3,3,6,3,4,"High",1,1
"3227",19,190,1,1.1796,124,49,8,7,1,4,5,1,4,"High",1,1
"3228",19,191,1,1.3222,29,133,8,4,2,4,6,2,4,"High",4,4
"3229",19,192,0,2.3171,8,44,1,2,4,4,8,4,4,"High",-1,1
"3230",19,193,0,1.9525,108,43,2,2,4,4,8,4,4,"High",0,0
"3231",19,194,1,0.89916,101,50,9,8,2,4,6,2,4,"High",1,1
"3232",19,195,1,0.93122,124,101,8,9,2,3,5,2,4,"High",-1,1
"3233",19,196,1,0.83309,124,29,8,8,3,3,6,3,4,"High",0,0
"3234",19,197,1,0.60187,124,101,8,9,4,4,8,4,4,"High",-1,1
"3235",19,198,0,1.2321,142,139,1,1,2,4,6,4,4,"High",0,0
"3236",19,199,0,1.1093,82,142,1,1,3,3,6,3,4,"High",0,0
"3237",19,200,0,0.7813,82,142,1,1,4,4,8,4,4,"High",0,0
"3238",20,1,1,1.0159,43,2,7,5,0,0,0,0,4,"Low",2,2
"3239",20,2,1,0.78046,143,107,9,5,0,0,0,0,4,"Low",4,4
"3240",20,3,0,2.8485,77,85,7,6,0,0,0,0,4,"Low",1,1
"3241",20,4,0,0.62894,43,89,7,10,1,0,1,0,4,"Low",-3,3
"3242",20,5,0,0.72727,42,143,5,9,0,1,1,1,4,"Low",-4,4
"3243",20,6,0,0.96003,51,101,3,6,0,0,0,0,4,"Low",-3,3
"3244",20,7,0,1.1168,35,143,9,9,0,2,2,2,4,"Low",0,0
"3245",20,8,1,0.58731,89,8,10,5,1,0,1,1,4,"Low",5,5
"3246",20,9,1,0.73359,126,65,3,5,0,0,0,0,4,"Low",-2,2
"3247",20,10,0,1.0152,63,43,3,7,0,2,2,2,4,"Low",-4,4
"3248",20,11,1,1.2727,141,6,10,5,0,0,0,0,4,"Low",5,5
"3249",20,12,0,1.0163,4,82,4,9,0,0,0,0,4,"Low",-5,5
"3250",20,13,1,2.0962,70,47,4,5,0,0,0,0,4,"Low",-1,1
"3251",20,14,1,1.5427,35,2,9,5,1,1,2,1,4,"Low",4,4
"3252",20,15,0,1.9398,46,107,3,5,0,1,1,1,4,"Low",-2,2
"3253",20,16,1,0.87219,115,5,5,3,0,0,0,0,4,"Low",2,2
"3254",20,17,1,1.6977,110,86,3,5,0,0,0,0,4,"Low",-2,2
"3255",20,18,0,1.0163,86,25,5,8,1,0,1,0,4,"Low",-3,3
"3256",20,19,1,2.0037,4,63,4,3,1,1,2,1,4,"Low",1,1
"3257",20,20,1,3.1933,2,66,5,3,2,0,2,2,4,"Low",2,2
"3258",20,21,1,1.4,85,66,6,3,1,1,2,1,4,"Low",3,3
"3259",20,22,1,0.93074,4,47,4,5,2,1,3,2,4,"Low",-1,1
"3260",20,23,1,1.0928,63,16,3,3,2,0,2,2,4,"Low",0,0
"3261",20,24,0,0.68349,50,71,7,10,0,0,0,0,4,"Low",-3,3
"3262",20,25,1,0.83818,78,51,5,3,0,1,1,0,4,"Low",2,2
"3263",20,26,1,0.56056,71,45,10,5,1,0,1,1,4,"Low",5,5
"3264",20,27,0,1.5768,46,30,3,7,1,0,1,0,4,"Low",-4,4
"3265",20,28,1,0.5666,3,30,8,7,0,1,1,0,4,"Low",1,1
"3266",20,29,0,2.7235,55,89,5,10,0,2,2,2,4,"Low",-5,5
"3267",20,30,0,0.91739,53,25,3,8,0,1,1,1,4,"Low",-5,5
"3268",20,31,1,1.6582,66,147,3,3,2,0,2,2,4,"Low",0,0
"3269",20,32,0,0.82224,124,34,5,10,0,0,0,0,4,"Low",-5,5
"3270",20,33,0,1.0049,25,89,8,10,2,3,5,3,4,"High",-2,2
"3271",20,34,1,0.71495,68,66,8,3,0,3,3,0,4,"Low",5,5
"3272",20,35,1,0.58364,65,87,5,5,1,0,1,1,4,"Low",0,0
"3273",20,36,1,2.1855,31,30,3,7,0,2,2,0,4,"Low",-4,4
"3274",20,37,1,0.70429,31,46,3,3,1,2,3,1,4,"Low",0,0
"3275",20,38,0,0.90711,55,48,5,5,1,0,1,0,4,"Low",0,0
"3276",20,39,0,1.4666,77,41,7,8,1,0,1,0,4,"Low",-1,1
"3277",20,40,0,2.5887,65,126,5,3,2,1,3,1,4,"Low",2,2
"3278",20,41,0,0.51132,126,3,3,8,2,1,3,1,4,"Low",-5,5
"3279",20,42,1,1.9587,143,96,9,7,3,0,3,3,4,"Low",2,2
"3280",20,43,1,1.1514,31,137,3,2,2,0,2,2,4,"Low",1,1
"3281",20,44,0,0.60422,77,3,7,8,2,2,4,2,4,"Low",-1,1
"3282",20,45,1,0.97083,65,42,5,5,3,1,4,3,4,"Low",0,0
"3283",20,46,0,0.57002,147,4,3,4,1,3,4,3,4,"Low",-1,1
"3284",20,47,1,0.95072,126,51,3,3,3,2,5,3,4,"High",0,0
"3285",20,48,1,0.86494,4,45,4,5,4,1,5,4,4,"High",-1,1
"3286",20,49,0,1.8323,31,2,3,5,3,3,6,3,4,"High",-2,2
"3287",20,50,0,1.1568,35,68,9,8,2,1,3,1,4,"Low",1,1
"3288",20,51,0,1.4861,147,5,3,3,2,1,3,1,4,"Low",0,0
"3289",20,52,1,0.71968,25,2,8,5,3,4,7,3,4,"High",3,3
"3290",20,53,0,1.1109,66,41,3,8,4,1,5,1,4,"High",-5,5
"3291",20,54,1,1.3195,126,115,3,5,4,1,5,4,4,"High",-2,2
"3292",20,55,1,1.0208,56,31,5,3,0,4,4,0,4,"Low",2,2
"3293",20,56,0,1.0861,47,86,5,5,2,2,4,2,4,"Low",0,0
"3294",20,57,1,1.7274,48,44,5,5,1,0,1,1,4,"Low",0,0
"3295",20,58,0,0.59638,47,3,5,8,3,3,6,3,4,"High",-3,3
"3296",20,59,1,0.84038,70,101,4,6,1,1,2,1,4,"Low",-2,2
"3297",20,60,0,0.79532,8,25,5,8,1,4,5,4,4,"High",-3,3
"3298",20,61,0,1.1542,51,56,3,5,3,1,4,1,4,"Low",-2,2
"3299",20,62,1,0.92058,68,51,8,3,2,4,6,2,4,"High",5,5
"3300",20,63,1,0.62204,7,87,2,5,0,1,1,0,4,"Low",-3,3
"3301",20,64,1,1.1446,65,30,5,7,4,3,7,4,4,"High",-2,2
"3302",20,65,0,2.1944,6,107,5,5,1,2,3,2,4,"Low",0,0
"3303",20,66,0,1.7968,5,101,3,6,2,2,4,2,4,"Low",-3,3
"3304",20,67,1,1.1812,48,79,5,8,2,0,2,2,4,"Low",-3,3
"3305",20,68,1,1.0565,82,133,9,5,1,0,1,1,4,"Low",4,4
"3306",20,69,0,1.2289,107,43,5,7,3,3,6,3,4,"High",-2,2
"3307",20,70,0,0.96905,41,96,8,7,2,1,3,1,4,"Low",1,1
"3308",20,71,1,1.2768,35,42,9,5,3,2,5,3,4,"High",4,4
"3309",20,72,1,1.178,82,107,9,5,2,4,6,2,4,"High",4,4
"3310",20,73,0,1.3703,124,44,5,5,1,1,2,1,4,"Low",0,0
"3311",20,74,1,1.0243,6,62,5,5,2,0,2,2,4,"Low",0,0
"3312",20,75,0,0.7308,35,71,9,10,4,2,6,2,4,"High",-1,1
"3313",20,76,0,1.3069,30,47,7,5,4,4,8,4,4,"High",2,2
"3314",20,77,0,1.0349,5,79,3,8,3,1,4,1,4,"Low",-5,5
"3315",20,78,1,0.71642,68,87,8,5,3,2,5,3,4,"High",3,3
"3316",20,79,0,0.83062,133,70,5,4,1,2,3,2,4,"Low",1,1
"3317",20,80,0,0.91712,137,101,2,6,1,3,4,3,4,"Low",-4,4
"3318",20,81,0,1.0069,6,44,5,5,3,2,5,2,4,"High",0,0
"3319",20,82,1,1.9958,129,43,10,7,0,4,4,0,4,"Low",3,3
"3320",20,83,0,1.0607,6,8,5,5,4,2,6,2,4,"High",0,0
"3321",20,84,0,1.0401,50,124,7,5,1,2,3,2,4,"Low",2,2
"3322",20,85,0,0.89344,46,86,3,5,3,3,6,3,4,"High",-2,2
"3323",20,86,0,0.97357,63,68,3,8,3,4,7,4,4,"High",-5,5
"3324",20,87,0,0.699,77,143,7,9,3,4,7,4,4,"High",-2,2
"3325",20,88,1,2.1361,70,101,4,6,3,4,7,3,4,"High",-2,2
"3326",20,89,0,1.2284,70,56,4,5,4,2,6,2,4,"High",-1,1
"3327",20,90,1,0.89619,44,110,5,3,3,1,4,3,4,"Low",2,2
"3328",20,91,0,0.69896,79,115,8,5,2,2,4,2,4,"Low",3,3
"3329",20,92,0,0.9136,34,141,10,10,1,1,2,1,4,"Low",0,0
"3330",20,93,1,0.96307,3,77,8,7,4,4,8,4,4,"High",1,1
"3331",20,94,1,2.7851,53,119,3,3,1,0,1,1,4,"Low",0,0
"3332",20,95,1,0.65892,48,115,5,5,3,3,6,3,4,"High",0,0
"3333",20,96,1,1.2191,56,8,5,5,3,3,6,3,4,"High",0,0
"3334",20,97,0,0.91629,62,34,5,10,1,2,3,2,4,"Low",-5,5
"3335",20,98,0,0.68373,45,110,5,3,2,2,4,2,4,"Low",2,2
"3336",20,99,1,1.2412,34,56,10,5,3,4,7,3,4,"High",5,5
"3337",20,100,0,0.79411,55,44,5,5,2,4,6,4,4,"High",0,0
"3338",20,101,1,1.3399,16,62,3,5,1,2,3,1,4,"Low",-2,2
"3339",20,102,0,0.57211,78,141,5,10,1,2,3,2,4,"Low",-5,5
"3340",20,103,0,0.63653,147,79,3,8,3,3,6,3,4,"High",-5,5
"3341",20,104,1,1.532,50,62,7,5,2,3,5,2,4,"High",2,2
"3342",20,105,0,4.0434,55,119,5,3,3,1,4,1,4,"Low",2,2
"3343",20,106,1,0.75317,110,42,3,5,3,3,6,3,4,"High",-2,2
"3344",20,107,1,0.93506,7,50,2,7,1,3,4,1,4,"Low",-5,5
"3345",20,108,0,1.4322,87,62,5,5,3,4,7,4,4,"High",0,0
"3346",20,109,0,1.1089,16,85,3,6,2,2,4,2,4,"Low",-3,3
"3347",20,110,0,3.1016,119,63,3,3,2,4,6,4,4,"High",0,0
"3348",20,111,0,0.94636,124,50,5,7,3,4,7,4,4,"High",-2,2
"3349",20,112,1,3.0405,55,46,5,3,4,4,8,4,4,"High",2,2
"3350",20,113,0,2.0446,86,78,5,5,4,2,6,2,4,"High",0,0
"3351",20,114,1,0.62786,141,45,10,5,3,3,6,3,4,"High",5,5
"3352",20,115,0,2.53,7,85,2,6,2,3,5,3,4,"High",-4,4
"3353",20,116,1,1.3236,115,45,5,5,4,4,8,4,4,"High",0,0
"3354",20,117,0,0.6181,42,89,5,10,4,4,8,4,4,"High",-5,5
"3355",20,118,1,0.76669,78,53,5,3,3,2,5,3,4,"High",2,2
"3356",20,119,1,1.1701,96,79,7,8,2,4,6,2,4,"High",-1,1
"3357",20,120,1,0.68395,8,16,5,3,4,3,7,4,4,"High",2,2
"3358",20,121,1,0.60361,34,82,10,9,4,3,7,4,4,"High",1,1
"3359",20,122,1,0.60094,129,41,10,8,1,3,4,1,4,"Low",2,2
"3360",20,123,1,0.70228,41,87,8,5,4,4,8,4,4,"High",3,3
"3361",20,124,0,6.9241,110,147,3,3,4,4,8,4,4,"High",0,0
"3362",20,125,0,2.148,133,85,5,6,2,4,6,4,4,"High",-1,1
"3363",20,126,0,1.1507,124,48,5,5,4,4,8,4,4,"High",0,0
"3364",20,127,0,0.91148,53,96,3,7,3,3,6,3,4,"High",-4,4
"3365",20,128,0,0.8325,96,82,7,9,4,4,8,4,4,"High",-2,2
"3366",20,129,0,0.61131,119,137,3,2,3,2,5,2,4,"High",1,1
"3367",20,130,0,1.2199,133,7,5,2,3,3,6,3,4,"High",3,3
"3368",20,131,0,0.64327,133,71,5,10,4,3,7,3,4,"High",-5,5
"3369",20,132,0,1.0937,7,78,2,5,4,4,8,4,4,"High",-3,3
"3370",20,133,0,0.61539,71,141,10,10,4,4,8,4,4,"High",0,0
"3371",20,134,1,0.69444,137,119,2,3,3,4,7,3,4,"High",-1,1
"3372",20,135,0,0.8375,16,137,3,2,4,4,8,4,4,"High",1,1
"3373",20,136,0,1.0848,5,53,3,3,4,4,8,4,4,"High",0,0
"3374",21,1,0,0.96528,96,89,2,4,0,0,0,0,4,"Low",-2,2
"3375",21,2,0,0.88191,25,32,5,3,0,0,0,0,4,"Low",2,2
"3376",21,3,0,1.2204,20,115,4,2,0,0,0,0,4,"Low",2,2
"3377",21,4,0,0.92256,9,116,2,4,0,0,0,0,4,"Low",-2,2
"3378",21,5,0,1.396,48,112,1,4,0,0,0,0,4,"Low",-3,3
"3379",21,6,1,1.4978,106,120,7,4,0,0,0,0,4,"Low",3,3
"3380",21,7,1,0.97868,34,147,7,2,0,0,0,0,4,"Low",5,5
"3381",21,8,0,0.92194,84,128,9,4,0,0,0,0,4,"Low",5,5
"3382",21,9,0,1.3767,4,108,3,3,0,0,0,0,4,"Low",0,0
"3383",21,10,0,1.3202,124,115,3,2,0,1,1,1,4,"Low",1,1
"3384",21,11,0,1.4561,143,16,3,5,0,0,0,0,4,"Low",-2,2
"3385",21,12,0,1.3961,4,16,3,5,1,1,2,1,4,"Low",-2,2
"3386",21,13,0,1.3222,145,2,5,5,0,0,0,0,4,"Low",0,0
"3387",21,14,1,2.2914,19,11,3,1,0,0,0,0,4,"Low",2,2
"3388",21,15,1,1.5742,12,55,2,3,0,0,0,0,4,"Low",-1,1
"3389",21,16,1,1.1822,33,3,5,4,0,0,0,0,4,"Low",1,1
"3390",21,17,1,1.707,93,38,3,1,0,0,0,0,4,"Low",2,2
"3391",21,18,1,1.3558,18,6,3,2,0,0,0,0,4,"Low",1,1
"3392",21,19,1,1.2835,108,129,3,2,1,0,1,1,4,"Low",1,1
"3393",21,20,1,0.95851,5,58,4,2,0,0,0,0,4,"Low",2,2
"3394",21,21,1,1.3105,128,79,4,3,1,0,1,1,4,"Low",1,1
"3395",21,22,1,1.2491,27,113,5,1,0,0,0,0,4,"Low",4,4
"3396",21,23,0,1.48,123,15,7,7,0,0,0,0,4,"Low",0,0
"3397",21,24,1,0.87005,34,58,7,2,1,1,2,1,4,"Low",5,5
"3398",21,25,0,1.0732,96,8,2,3,1,0,1,0,4,"Low",-1,1
"3399",21,26,1,1.0808,61,101,2,2,0,0,0,0,4,"Low",0,0
"3400",21,27,1,1.0819,45,110,7,2,0,0,0,0,4,"Low",5,5
"3401",21,28,0,1.3888,48,49,1,4,1,0,1,0,4,"Low",-3,3
"3402",21,29,1,1.8213,8,116,3,4,1,1,2,1,4,"Low",-1,1
"3403",21,30,0,1.4193,121,60,2,7,0,0,0,0,4,"Low",-5,5
"3404",21,31,0,1.2487,71,2,2,5,0,1,1,1,4,"Low",-3,3
"3405",21,32,1,1.1608,30,108,8,3,0,2,2,0,4,"Low",5,5
"3406",21,33,0,1.2755,6,50,2,5,1,0,1,0,4,"Low",-3,3
"3407",21,34,0,1.1996,129,137,2,4,1,0,1,0,4,"Low",-2,2
"3408",21,35,1,1.4535,30,128,8,4,1,2,3,1,4,"Low",4,4
"3409",21,36,0,1.7303,18,112,3,4,1,1,2,1,4,"Low",-1,1
"3410",21,37,1,0.95767,50,38,5,1,1,1,2,1,4,"Low",4,4
"3411",21,38,1,1.2379,53,96,2,2,0,2,2,0,4,"Low",0,0
"3412",21,39,1,0.92264,105,11,4,1,0,1,1,0,4,"Low",3,3
"3413",21,40,1,1.0599,18,118,3,5,2,0,2,2,4,"Low",-2,2
"3414",21,41,1,1.2879,56,96,3,2,0,3,3,0,4,"Low",1,1
"3415",21,42,0,1.228,23,94,1,5,0,0,0,0,4,"Low",-4,4
"3416",21,43,1,1.4379,19,53,3,2,1,1,2,1,4,"Low",1,1
"3417",21,44,0,1.2741,106,83,7,9,1,0,1,0,4,"Low",-2,2
"3418",21,45,1,1.3555,147,121,2,2,1,1,2,1,4,"Low",0,0
"3419",21,46,0,1.4487,113,25,1,5,1,1,2,1,4,"Low",-4,4
"3420",21,47,1,1.1327,56,121,3,2,1,2,3,1,4,"Low",1,1
"3421",21,48,0,1.3735,8,137,3,4,2,1,3,1,4,"Low",-1,1
"3422",21,49,1,1.6301,112,6,4,2,2,2,4,2,4,"Low",2,2
"3423",21,50,0,1.1947,145,58,5,2,1,2,3,2,4,"Low",3,3
"3424",21,51,0,0.87513,147,19,2,3,2,2,4,2,4,"Low",-1,1
"3425",21,52,0,1.2898,51,15,3,7,0,1,1,1,4,"Low",-4,4
"3426",21,53,1,1.9012,136,38,2,1,0,2,2,0,4,"Low",1,1
"3427",21,54,0,0.95922,56,116,3,4,2,2,4,2,4,"Low",-1,1
"3428",21,55,0,0.91304,25,27,5,5,2,1,3,1,4,"Low",0,0
"3429",21,56,0,1.1281,120,30,4,8,1,2,3,2,4,"Low",-4,4
"3430",21,57,1,1.1406,122,89,4,4,0,1,1,0,4,"Low",0,0
"3431",21,58,0,1.98,120,82,4,7,2,0,2,0,4,"Low",-3,3
"3432",21,59,0,1.1373,55,70,3,3,1,0,1,0,4,"Low",0,0
"3433",21,60,1,1.4734,126,8,1,3,0,3,3,0,4,"Low",-2,2
"3434",21,61,1,2.6674,97,31,1,1,0,0,0,0,4,"Low",0,0
"3435",21,62,1,1.1649,35,104,9,7,0,0,0,0,4,"Low",2,2
"3436",21,63,1,1.8204,4,61,3,2,2,1,3,2,4,"Low",1,1
"3437",21,64,1,2.0328,114,48,1,1,0,2,2,0,4,"Low",0,0
"3438",21,65,1,1.3098,106,19,7,3,2,3,5,2,4,"High",4,4
"3439",21,66,0,1.6864,56,2,3,5,3,2,5,2,4,"High",-2,2
"3440",21,67,1,1.4377,146,124,2,3,0,1,1,0,4,"Low",-1,1
"3441",21,68,0,1.7285,136,101,2,2,1,1,2,1,4,"Low",0,0
"3442",21,69,0,1.1426,121,106,2,7,3,3,6,3,4,"High",-5,5
"3443",21,70,1,1.4765,130,126,1,1,0,1,1,0,4,"Low",0,0
"3444",21,71,0,1.0646,114,85,1,3,1,0,1,0,4,"Low",-2,2
"3445",21,72,0,0.84337,96,119,2,4,4,0,4,0,4,"Low",-2,2
"3446",21,73,1,0.77202,12,27,2,5,1,2,3,1,4,"Low",-3,3
"3447",21,74,1,1.3049,7,38,3,1,0,3,3,0,4,"Low",2,2
"3448",21,75,0,1.5612,7,3,3,4,1,1,2,1,4,"Low",-1,1
"3449",21,76,1,1.9372,118,82,5,7,1,1,2,1,4,"Low",-2,2
"3450",21,77,1,1.3622,89,20,4,4,2,1,3,2,4,"Low",0,0
"3451",21,78,1,1.1543,77,11,5,1,0,2,2,0,4,"Low",4,4
"3452",21,79,0,1.2022,113,61,1,2,2,2,4,2,4,"Low",-1,1
"3453",21,80,1,0.80006,85,38,3,1,1,4,5,1,4,"High",2,2
"3454",21,81,1,0.9104,45,68,7,4,1,0,1,1,4,"Low",3,3
"3455",21,82,0,1.3682,147,82,2,7,3,2,5,2,4,"High",-5,5
"3456",21,83,1,1.5103,35,15,9,7,1,2,3,1,4,"Low",2,2
"3457",21,84,0,1.0122,128,30,4,8,3,3,6,3,4,"High",-4,4
"3458",21,85,0,1.2138,16,35,5,9,2,2,4,2,4,"Low",-4,4
"3459",21,86,1,1.5845,61,146,2,2,3,1,4,3,4,"Low",0,0
"3460",21,87,0,1.551,123,84,7,9,1,1,2,1,4,"Low",-2,2
"3461",21,88,0,0.94978,114,79,1,3,2,1,3,1,4,"Low",-2,2
"3462",21,89,0,0.82991,123,30,7,8,2,4,6,4,4,"High",-1,1
"3463",21,90,0,1.0347,110,119,2,4,1,1,2,1,4,"Low",-2,2
"3464",21,91,1,1.3752,10,136,3,2,0,2,2,0,4,"Low",1,1
"3465",21,92,1,1.7188,4,82,3,7,3,3,6,3,4,"High",-4,4
"3466",21,93,0,1.0082,55,94,3,5,2,1,3,1,4,"Low",-2,2
"3467",21,94,0,1.0623,7,27,3,5,2,3,5,3,4,"High",-2,2
"3468",21,95,1,0.70957,123,32,7,3,3,1,4,3,4,"Low",4,4
"3469",21,96,1,1.3495,147,56,2,3,4,4,8,4,4,"High",-1,1
"3470",21,97,1,1.1816,104,60,7,7,1,1,2,1,4,"Low",0,0
"3471",21,98,1,1.5255,58,136,2,2,3,3,6,3,4,"High",0,0
"3472",21,99,1,0.97643,84,82,9,7,2,4,6,2,4,"High",2,2
"3473",21,100,1,0.85544,137,20,4,4,2,2,4,2,4,"Low",0,0
"3474",21,101,0,0.83318,119,84,4,9,2,3,5,3,4,"High",-5,5
"3475",21,102,1,0.80701,114,23,1,1,3,1,4,3,4,"Low",0,0
"3476",21,103,1,1.0543,35,42,9,4,3,0,3,3,4,"Low",5,5
"3477",21,104,1,1.3627,25,126,5,1,3,2,5,3,4,"High",4,4
"3478",21,105,1,0.63372,45,108,7,3,2,3,5,2,4,"High",4,4
"3479",21,106,1,0.82422,29,89,7,4,0,3,3,0,4,"Low",3,3
"3480",21,107,1,1.2461,12,94,2,5,2,2,4,2,4,"Low",-3,3
"3481",21,108,1,1.162,113,124,1,3,3,2,5,3,4,"High",-2,2
"3482",21,109,1,0.8101,12,27,2,5,3,4,7,3,4,"High",-3,3
"3483",21,110,0,1.0615,69,77,3,5,0,1,1,1,4,"Low",-2,2
"3484",21,111,1,1.2822,7,137,3,4,3,3,6,3,4,"High",-1,1
"3485",21,112,1,1.0496,58,121,2,2,4,4,8,4,4,"High",0,0
"3486",21,113,0,0.89362,136,119,2,4,4,3,7,3,4,"High",-2,2
"3487",21,114,1,0.88108,19,114,3,1,4,4,8,4,4,"High",2,2
"3488",21,115,0,1.1157,115,128,2,4,2,4,6,4,4,"High",-2,2
"3489",21,116,0,0.92514,42,35,4,9,1,4,5,4,4,"High",-5,5
"3490",21,117,1,1.0938,79,13,3,1,2,0,2,2,4,"Low",2,2
"3491",21,118,0,1.0243,46,83,8,9,0,1,1,1,4,"Low",-1,1
"3492",21,119,0,0.9144,31,50,1,5,1,2,3,2,4,"Low",-4,4
"3493",21,120,0,0.77976,55,71,3,2,3,1,4,1,4,"Low",1,1
"3494",21,121,1,1.0665,126,97,1,1,3,1,4,3,4,"Low",0,0
"3495",21,122,1,0.92407,112,49,4,4,3,1,4,3,4,"Low",0,0
"3496",21,123,0,1.538,119,16,4,5,4,3,7,3,4,"High",-1,1
"3497",21,124,1,1.3006,32,89,3,4,2,4,6,2,4,"High",-1,1
"3498",21,125,0,1.0162,49,3,4,4,2,2,4,2,4,"Low",0,0
"3499",21,126,1,1.4649,7,12,3,2,4,4,8,4,4,"High",1,1
"3500",21,127,1,0.652,45,10,7,3,3,1,4,3,4,"Low",4,4
"3501",21,128,0,1.313,55,49,3,4,4,3,7,3,4,"High",-1,1
"3502",21,129,1,1.0284,104,42,7,4,2,2,4,2,4,"Low",3,3
"3503",21,130,1,1.8708,71,6,2,2,2,3,5,2,4,"High",0,0
"3504",21,131,0,0.96908,120,123,4,7,3,4,7,4,4,"High",-3,3
"3505",21,132,1,1.3265,77,112,5,4,2,4,6,2,4,"High",1,1
"3506",21,133,1,1.0417,61,23,2,1,4,2,6,4,4,"High",1,1
"3507",21,134,1,0.77995,45,78,7,4,4,0,4,4,4,"Low",3,3
"3508",21,135,1,0.95734,53,101,2,2,2,2,4,2,4,"Low",0,0
"3509",21,136,0,1.7381,11,120,1,4,3,4,7,4,4,"High",-3,3
"3510",21,137,0,0.97185,94,118,5,5,3,2,5,2,4,"High",0,0
"3511",21,138,1,0.92201,18,23,3,1,3,3,6,3,4,"High",2,2
"3512",21,139,0,1.1609,13,11,1,1,1,4,5,4,4,"High",0,0
"3513",21,140,0,0.89292,145,83,5,9,2,2,4,2,4,"Low",-4,4
"3514",21,141,1,1.2101,105,78,4,4,1,1,2,1,4,"Low",0,0
"3515",21,142,1,1.8663,145,71,5,2,3,3,6,3,4,"High",3,3
"3516",21,143,0,1.5725,4,116,3,4,4,3,7,3,4,"High",-1,1
"3517",21,144,1,1.0657,105,51,4,3,2,1,3,2,4,"Low",1,1
"3518",21,145,1,1.9642,143,8,3,3,1,4,5,1,4,"High",0,0
"3519",21,146,1,0.85038,33,130,5,1,1,1,2,1,4,"Low",4,4
"3520",21,147,1,1.223,69,9,3,2,1,1,2,1,4,"Low",1,1
"3521",21,148,0,1.6206,41,126,1,1,0,4,4,4,4,"Low",0,0
"3522",21,149,0,1.0793,129,18,2,3,2,4,6,4,4,"High",-1,1
"3523",21,150,1,1.0148,34,108,7,3,2,4,6,2,4,"High",4,4
"3524",21,151,1,0.98767,33,16,5,5,2,4,6,2,4,"High",0,0
"3525",21,152,1,0.95485,110,51,2,3,2,2,4,2,4,"Low",-1,1
"3526",21,153,1,1.3203,69,31,3,1,2,2,4,2,4,"Low",2,2
"3527",21,154,0,1.2144,146,106,2,7,2,4,6,4,4,"High",-5,5
"3528",21,155,1,0.89396,77,115,5,2,3,3,6,3,4,"High",3,3
"3529",21,156,0,1.5692,49,31,4,1,4,3,7,3,4,"High",3,3
"3530",21,157,1,1.0146,85,31,3,1,2,4,6,2,4,"High",2,2
"3531",21,158,0,1.6934,23,10,1,3,4,2,6,2,4,"High",-2,2
"3532",21,159,1,1.0329,2,9,5,2,3,2,5,3,4,"High",3,3
"3533",21,160,1,1.4229,79,48,3,1,3,3,6,3,4,"High",2,2
"3534",21,161,0,1.2117,143,15,3,7,2,3,5,3,4,"High",-4,4
"3535",21,162,1,2.0243,60,53,7,2,2,3,5,2,4,"High",5,5
"3536",21,163,1,1.1328,10,9,3,2,3,3,6,3,4,"High",1,1
"3537",21,164,1,1.2524,116,53,4,2,4,4,8,4,4,"High",2,2
"3538",21,165,0,1.2645,130,77,1,5,2,4,6,4,4,"High",-4,4
"3539",21,166,0,1.5812,51,69,3,3,3,3,6,3,4,"High",0,0
"3540",21,167,0,1.6,71,25,2,5,4,4,8,4,4,"High",-3,3
"3541",21,168,0,0.65249,124,15,3,7,3,4,7,4,4,"High",-4,4
"3542",21,169,0,1.774,97,115,1,2,2,4,6,4,4,"High",-1,1
"3543",21,170,0,1.0559,20,10,4,3,3,4,7,4,4,"High",1,1
"3544",21,171,0,1.5979,129,110,2,2,3,3,6,3,4,"High",0,0
"3545",21,172,0,1.1809,20,2,4,5,4,4,8,4,4,"High",-1,1
"3546",21,173,0,1.4434,69,93,3,3,4,1,5,1,4,"High",0,0
"3547",21,174,0,1.0463,118,84,5,9,3,4,7,4,4,"High",-4,4
"3548",21,175,1,1.0687,68,146,4,2,1,3,4,1,4,"Low",2,2
"3549",21,176,1,0.93374,79,101,3,2,4,3,7,4,4,"High",1,1
"3550",21,177,1,1.1105,70,124,3,3,1,4,5,1,4,"High",0,0
"3551",21,178,1,1.1164,118,101,5,2,4,4,8,4,4,"High",3,3
"3552",21,179,0,1.0213,68,46,4,8,2,1,3,1,4,"Low",-4,4
"3553",21,180,1,1.462,137,6,4,2,4,4,8,4,4,"High",2,2
"3554",21,181,0,1.2984,130,105,1,4,3,3,6,3,4,"High",-3,3
"3555",21,182,1,0.71149,33,130,5,1,3,4,7,3,4,"High",4,4
"3556",21,183,1,0.81624,78,32,4,3,2,3,5,2,4,"High",1,1
"3557",21,184,1,1.0409,60,129,7,2,3,4,7,3,4,"High",5,5
"3558",21,185,0,1.134,13,143,1,3,2,3,5,3,4,"High",-2,2
"3559",21,186,0,1.2156,60,104,7,7,4,3,7,3,4,"High",0,0
"3560",21,187,1,1.0851,105,146,4,2,4,4,8,4,4,"High",2,2
"3561",21,188,1,3.0632,113,48,1,1,4,4,8,4,4,"High",0,0
"3562",21,189,1,0.99306,122,51,4,3,1,4,5,1,4,"High",1,1
"3563",21,190,1,1.912,70,42,3,4,2,3,5,2,4,"High",-1,1
"3564",21,191,0,1.4195,97,3,1,4,3,3,6,3,4,"High",-3,3
"3565",21,192,1,0.68868,50,13,5,1,3,3,6,3,4,"High",4,4
"3566",21,193,0,0.72237,42,33,4,5,4,4,8,4,4,"High",-1,1
"3567",21,194,1,1.2035,32,5,3,4,4,1,5,4,4,"High",-1,1
"3568",21,195,0,1.1629,5,78,4,4,2,3,5,3,4,"High",0,0
"3569",21,196,0,1.0184,110,68,2,4,4,3,7,3,4,"High",-2,2
"3570",21,197,0,0.84512,13,5,1,4,4,3,7,3,4,"High",-3,3
"3571",21,198,1,1.0772,5,41,4,1,4,1,5,4,4,"High",3,3
"3572",21,199,1,0.6477,46,29,8,7,2,1,3,2,4,"Low",1,1
"3573",21,200,0,0.70067,41,85,1,3,2,3,5,3,4,"High",-2,2
"3574",22,1,1,1.1944,82,115,4,2,0,0,0,0,4,"Low",2,2
"3575",22,2,0,1.5928,122,123,1,3,0,0,0,0,4,"Low",-2,2
"3576",22,3,1,1.9125,126,70,2,4,0,0,0,0,4,"Low",-2,2
"3577",22,4,1,2.3056,131,16,4,4,0,0,0,0,4,"Low",0,0
"3578",22,5,0,1.9691,45,92,3,5,0,0,0,0,4,"Low",-2,2
"3579",22,6,0,0.97571,5,77,2,3,0,0,0,0,4,"Low",-1,1
"3580",22,7,1,1.1711,62,50,5,4,0,0,0,0,4,"Low",1,1
"3581",22,8,1,9.5865,106,43,2,3,0,0,0,0,4,"Low",-1,1
"3582",22,9,1,0.9181,109,147,5,2,0,0,0,0,4,"Low",3,3
"3583",22,10,0,2.6762,34,142,5,3,0,0,0,0,4,"Low",2,2
"3584",22,11,0,0.7747,11,96,2,7,0,0,0,0,4,"Low",-5,5
"3585",22,12,0,1.0867,42,2,3,3,0,0,0,0,4,"Low",0,0
"3586",22,13,1,1.0111,72,120,1,2,0,0,0,0,4,"Low",-1,1
"3587",22,14,0,1.4687,142,46,3,5,1,0,1,0,4,"Low",-2,2
"3588",22,15,1,0.98187,28,120,4,2,0,1,1,0,4,"Low",2,2
"3589",22,16,0,1.2791,36,131,2,4,0,1,1,1,4,"Low",-2,2
"3590",22,17,0,1.5675,84,114,1,1,0,0,0,0,4,"Low",0,0
"3591",22,18,1,5.4757,36,42,2,3,1,1,2,1,4,"Low",-1,1
"3592",22,19,1,0.67864,128,19,5,3,0,0,0,0,4,"Low",2,2
"3593",22,20,0,0.84372,27,100,2,6,0,0,0,0,4,"Low",-4,4
"3594",22,21,0,0.78385,70,124,4,6,1,0,1,0,4,"Low",-2,2
"3595",22,22,0,2.3326,35,46,3,5,0,1,1,1,4,"Low",-2,2
"3596",22,23,0,1.8141,12,28,2,4,0,1,1,1,4,"Low",-2,2
"3597",22,24,1,1.124,131,41,4,6,2,0,2,2,4,"Low",-2,2
"3598",22,25,1,0.90481,137,110,2,3,0,0,0,0,4,"Low",-1,1
"3599",22,26,1,0.82628,124,43,6,3,1,1,2,1,4,"Low",3,3
"3600",22,27,1,2.3356,82,53,4,2,1,0,1,1,4,"Low",2,2
"3601",22,28,0,1.3951,5,130,2,1,1,0,1,0,4,"Low",1,1
"3602",22,29,0,2.0349,147,84,2,1,1,1,2,1,4,"Low",1,1
"3603",22,30,0,1.2195,82,53,4,2,2,1,3,1,4,"Low",2,2
"3604",22,31,0,2.9948,19,107,3,4,1,0,1,0,4,"Low",-1,1
"3605",22,32,0,1.3305,89,78,3,5,0,0,0,0,4,"Low",-2,2
"3606",22,33,1,0.86858,61,79,4,3,0,0,0,0,4,"Low",1,1
"3607",22,34,0,0.71182,125,23,4,2,0,0,0,0,4,"Low",2,2
"3608",22,35,1,1.2171,60,13,4,3,0,0,0,0,4,"Low",1,1
"3609",22,36,0,1.036,120,5,2,2,2,2,4,2,4,"Low",0,0
"3610",22,37,0,1.0173,130,16,1,4,1,1,2,1,4,"Low",-3,3
"3611",22,38,0,1.2733,147,37,2,2,2,0,2,0,4,"Low",0,0
"3612",22,39,0,1.61,123,131,3,4,1,3,4,3,4,"Low",-1,1
"3613",22,40,1,0.89772,124,130,6,1,2,2,4,2,4,"Low",5,5
"3614",22,41,0,1.1782,6,114,4,1,0,1,1,1,4,"Low",3,3
"3615",22,42,1,1.0908,147,145,2,1,3,0,3,3,4,"Low",1,1
"3616",22,43,0,0.95002,84,72,1,1,2,1,3,1,4,"Low",0,0
"3617",22,44,0,0.76481,40,24,5,1,0,0,0,0,4,"Low",4,4
"3618",22,45,0,1.1631,123,23,3,2,2,1,3,1,4,"Low",1,1
"3619",22,46,1,0.74744,13,38,3,1,1,0,1,1,4,"Low",2,2
"3620",22,47,1,0.80308,86,6,3,4,0,1,1,0,4,"Low",-1,1
"3621",22,48,0,2.1109,27,70,2,4,1,2,3,2,4,"Low",-2,2
"3622",22,49,0,1.2831,50,70,4,4,1,3,4,3,4,"Low",0,0
"3623",22,50,0,1.2265,68,84,4,1,0,3,3,3,4,"Low",3,3
"3624",22,51,1,3.4361,129,35,3,3,0,1,1,0,4,"Low",0,0
"3625",22,52,1,0.83448,78,71,5,4,1,0,1,1,4,"Low",1,1
"3626",22,53,1,1.1008,68,18,4,1,1,0,1,1,4,"Low",3,3
"3627",22,54,0,0.75879,114,25,1,6,2,0,2,0,4,"Low",-5,5
"3628",22,55,1,1.4069,89,34,3,5,1,1,2,1,4,"Low",-2,2
"3629",22,56,1,1.0523,48,84,3,1,0,4,4,0,4,"Low",2,2
"3630",22,57,1,3.3897,88,108,4,2,0,0,0,0,4,"Low",2,2
"3631",22,58,1,1.1177,79,129,3,3,1,1,2,1,4,"Low",0,0
"3632",22,59,1,1.0211,142,2,3,3,2,1,3,2,4,"Low",0,0
"3633",22,60,1,0.70961,40,115,5,2,1,1,2,1,4,"Low",3,3
"3634",22,61,1,0.74043,25,44,6,5,1,0,1,1,4,"Low",1,1
"3635",22,62,1,0.63671,25,6,6,4,2,2,4,2,4,"Low",2,2
"3636",22,63,1,0.76526,72,68,1,4,2,2,4,2,4,"Low",-3,3
"3637",22,64,1,3.0651,126,28,2,4,1,2,3,1,4,"Low",-2,2
"3638",22,65,0,1.8369,6,35,4,3,3,2,5,2,4,"High",1,1
"3639",22,66,1,1.1619,40,19,5,3,2,2,4,2,4,"Low",2,2
"3640",22,67,1,0.99221,47,94,3,2,0,0,0,0,4,"Low",1,1
"3641",22,68,0,0.7564,42,23,3,2,2,2,4,2,4,"Low",1,1
"3642",22,69,0,0.79511,28,87,4,4,3,0,3,0,4,"Low",0,0
"3643",22,70,1,0.76489,28,147,4,2,4,4,8,4,4,"High",2,2
"3644",22,71,0,2.9817,47,107,3,4,1,1,2,1,4,"Low",-1,1
"3645",22,72,0,1.6163,145,114,1,1,1,3,4,3,4,"Low",0,0
"3646",22,73,1,1.105,43,2,3,3,2,2,4,2,4,"Low",0,0
"3647",22,74,0,0.73623,78,63,5,3,2,0,2,0,4,"Low",2,2
"3648",22,75,1,1.1707,47,125,3,4,2,1,3,2,4,"Low",-1,1
"3649",22,76,1,1.538,62,24,5,1,1,1,2,1,4,"Low",4,4
"3650",22,77,1,1.5806,80,15,4,2,0,0,0,0,4,"Low",2,2
"3651",22,78,1,3.8732,86,123,3,3,1,3,4,1,4,"Low",0,0
"3652",22,79,1,1.5507,124,72,6,1,3,3,6,3,4,"High",5,5
"3653",22,80,1,1.1413,62,129,5,3,2,2,4,2,4,"Low",2,2
"3654",22,81,1,0.78673,126,12,2,2,2,1,3,2,4,"Low",0,0
"3655",22,82,0,1.685,129,92,3,5,3,1,4,1,4,"Low",-2,2
"3656",22,83,1,0.84176,89,19,3,3,2,3,5,2,4,"High",0,0
"3657",22,84,1,0.9902,16,106,4,2,2,1,3,2,4,"Low",2,2
"3658",22,85,1,0.85573,68,112,4,2,3,0,3,3,4,"Low",2,2
"3659",22,86,0,0.81309,143,80,3,4,0,1,1,1,4,"Low",-1,1
"3660",22,87,1,1.0903,48,43,3,3,1,3,4,1,4,"Low",0,0
"3661",22,88,0,1.523,82,79,4,3,3,2,5,2,4,"High",1,1
"3662",22,89,1,3.1518,37,34,2,5,1,2,3,1,4,"Low",-3,3
"3663",22,90,0,1.9811,71,8,4,3,1,0,1,0,4,"Low",1,1
"3664",22,91,0,2.4685,108,37,2,2,1,2,3,2,4,"Low",0,0
"3665",22,92,0,1.0928,38,78,1,5,1,3,4,3,4,"Low",-4,4
"3666",22,93,0,2.0935,95,15,1,2,0,1,1,1,4,"Low",-1,1
"3667",22,94,0,0.79938,48,80,3,4,2,2,4,2,4,"Low",-1,1
"3668",22,95,0,1.1349,4,23,3,2,0,3,3,3,4,"Low",1,1
"3669",22,96,0,1.1974,106,44,2,5,2,1,3,1,4,"Low",-3,3
"3670",22,97,0,1.1763,91,72,1,1,0,4,4,4,4,"Low",0,0
"3671",22,98,0,0.89594,112,61,2,4,1,1,2,1,4,"Low",-2,2
"3672",22,99,0,3.3053,12,5,2,2,2,3,5,3,4,"High",0,0
"3673",22,100,0,0.8254,120,100,2,6,3,1,4,1,4,"Low",-4,4
"3674",22,101,1,2.7418,61,106,4,2,2,3,5,2,4,"High",2,2
"3675",22,102,1,1.1019,107,114,4,1,2,4,6,2,4,"High",3,3
"3676",22,103,0,1.0013,112,49,2,5,2,0,2,0,4,"Low",-3,3
"3677",22,104,1,0.76869,41,32,6,3,1,0,1,1,4,"Low",3,3
"3678",22,105,1,1.9133,94,123,2,3,1,4,5,1,4,"High",-1,1
"3679",22,106,1,0.56405,40,129,5,3,3,4,7,3,4,"High",2,2
"3680",22,107,0,1.2992,110,15,3,2,1,2,3,2,4,"Low",1,1
"3681",22,108,1,1.3187,124,68,6,4,4,4,8,4,4,"High",2,2
"3682",22,109,1,0.88892,44,113,5,3,2,0,2,2,4,"Low",2,2
"3683",22,110,1,0.72882,25,128,6,5,3,1,4,3,4,"Low",1,1
"3684",22,111,0,2.8696,86,126,3,2,2,3,5,3,4,"High",1,1
"3685",22,112,0,0.90244,44,82,5,4,3,4,7,4,4,"High",1,1
"3686",22,113,1,0.71174,43,18,3,1,4,1,5,4,4,"High",2,2
"3687",22,114,0,1.1415,18,50,1,4,2,2,4,2,4,"Low",-3,3
"3688",22,115,0,0.99168,32,8,3,3,1,1,2,1,4,"Low",0,0
"3689",22,116,0,0.74902,78,6,5,4,4,4,8,4,4,"High",1,1
"3690",22,117,0,0.64762,11,141,2,4,1,0,1,0,4,"Low",-2,2
"3691",22,118,0,0.89913,5,96,2,7,4,1,5,1,4,"High",-5,5
"3692",22,119,1,0.78723,128,24,5,1,2,2,4,2,4,"Low",4,4
"3693",22,120,0,0.77907,125,141,4,4,2,1,3,1,4,"Low",0,0
"3694",22,121,0,1.3632,106,86,2,3,4,3,7,3,4,"High",-1,1
"3695",22,122,0,1.0912,88,142,4,3,1,3,4,3,4,"Low",1,1
"3696",22,123,1,1.4109,109,120,5,2,1,4,5,1,4,"High",3,3
"3697",22,124,0,1.3141,94,87,2,4,2,1,3,1,4,"Low",-2,2
"3698",22,125,1,1.6814,101,88,3,4,0,2,2,0,4,"Low",-1,1
"3699",22,126,1,0.86791,100,128,6,5,2,3,5,2,4,"High",1,1
"3700",22,127,0,0.77596,112,63,2,3,3,1,4,1,4,"Low",-1,1
"3701",22,128,1,0.81353,107,128,4,5,3,4,7,3,4,"High",-1,1
"3702",22,129,1,2.9461,145,91,1,1,2,1,3,2,4,"Low",0,0
"3703",22,130,0,1.2836,130,41,1,6,3,2,5,2,4,"High",-5,5
"3704",22,131,1,1.483,142,95,3,1,4,1,5,4,4,"High",2,2
"3705",22,132,0,0.84906,36,79,2,3,2,3,5,3,4,"High",-1,1
"3706",22,133,0,6.7361,44,60,5,4,4,1,5,1,4,"High",1,1
"3707",22,134,0,1.1624,110,92,3,5,2,2,4,2,4,"Low",-2,2
"3708",22,135,1,1.0438,137,34,2,5,1,3,4,1,4,"Low",-3,3
"3709",22,136,0,1.2385,112,35,2,3,4,3,7,3,4,"High",-1,1
"3710",22,137,0,1.6124,125,108,4,2,3,2,5,2,4,"High",2,2
"3711",22,138,0,0.91188,91,110,1,3,2,3,5,3,4,"High",-2,2
"3712",22,139,1,0.62884,131,35,4,3,4,4,8,4,4,"High",1,1
"3713",22,140,1,1.1675,143,110,3,3,1,4,5,1,4,"High",0,0
"3714",22,141,1,1.1665,113,36,3,2,1,3,4,1,4,"Low",1,1
"3715",22,142,1,1.0148,63,18,3,1,2,3,5,2,4,"High",2,2
"3716",22,143,0,1.0306,7,71,3,4,0,2,2,2,4,"Low",-1,1
"3717",22,144,0,3.0844,145,49,1,5,3,1,4,1,4,"Low",-4,4
"3718",22,145,1,3.6749,107,62,4,5,4,3,7,4,4,"High",-1,1
"3719",22,146,0,2.9386,2,27,3,2,3,2,5,2,4,"High",1,1
"3720",22,147,0,0.96989,36,87,2,4,4,2,6,2,4,"High",-2,2
"3721",22,148,0,2.8312,136,48,4,3,0,3,3,3,4,"Low",1,1
"3722",22,149,1,1.0453,92,45,5,3,3,1,4,3,4,"Low",2,2
"3723",22,150,0,0.9939,101,100,3,6,1,3,4,3,4,"Low",-3,3
"3724",22,151,1,3.6152,11,95,2,1,2,2,4,2,4,"Low",1,1
"3725",22,152,0,0.64603,108,141,2,4,3,2,5,2,4,"High",-2,2
"3726",22,153,1,1.1462,126,2,2,3,4,4,8,4,4,"High",-1,1
"3727",22,154,0,0.73272,109,40,5,5,2,4,6,4,4,"High",0,0
"3728",22,155,1,0.59615,62,136,5,4,4,1,5,4,4,"High",1,1
"3729",22,156,0,0.78082,27,79,2,3,3,4,7,4,4,"High",-1,1
"3730",22,157,0,1.0464,127,77,3,3,0,1,1,1,4,"Low",0,0
"3731",22,158,0,1.0164,86,63,3,3,4,3,7,3,4,"High",0,0
"3732",22,159,1,0.93818,136,130,4,1,2,4,6,2,4,"High",3,3
"3733",22,160,0,3.1844,70,56,4,4,4,0,4,0,4,"Low",0,0
"3734",22,161,0,2.736,15,61,2,4,3,3,6,3,4,"High",-2,2
"3735",22,162,0,1.1179,137,25,2,6,2,4,6,4,4,"High",-4,4
"3736",22,163,1,0.62329,109,33,5,1,3,0,3,3,4,"Low",4,4
"3737",22,164,0,1.5792,136,109,4,5,3,4,7,4,4,"High",-1,1
"3738",22,165,0,0.6253,85,56,3,4,0,1,1,1,4,"Low",-1,1
"3739",22,166,1,0.82754,24,32,1,3,3,2,5,3,4,"High",-2,2
"3740",22,167,1,2.5292,87,125,4,4,3,4,7,3,4,"High",0,0
"3741",22,168,1,0.64357,63,38,3,1,4,2,6,4,4,"High",2,2
"3742",22,169,1,0.58617,92,38,5,1,4,3,7,4,4,"High",4,4
"3743",22,170,1,0.82903,145,11,1,2,4,3,7,4,4,"High",-1,1
"3744",22,171,0,1.4284,15,137,2,2,4,3,7,3,4,"High",0,0
"3745",22,172,1,1.1897,50,94,4,2,3,3,6,3,4,"High",2,2
"3746",22,173,0,1.1243,49,23,5,2,2,4,6,4,4,"High",3,3
"3747",22,174,1,0.81051,47,49,3,5,3,3,6,3,4,"High",-2,2
"3748",22,175,1,0.82316,60,91,4,1,2,3,5,2,4,"High",3,3
"3749",22,176,0,2.7269,42,95,3,1,3,3,6,3,4,"High",2,2
"3750",22,177,0,1.9119,85,141,3,4,1,3,4,3,4,"Low",-1,1
"3751",22,178,0,5.2899,18,95,1,1,4,4,8,4,4,"High",0,0
"3752",22,179,1,1.1228,48,34,3,5,4,4,8,4,4,"High",-2,2
"3753",22,180,1,1.9589,53,136,2,4,2,4,6,2,4,"High",-2,2
"3754",22,181,0,1.45,16,141,4,4,3,4,7,4,4,"High",0,0
"3755",22,182,1,0.72272,108,38,2,1,4,4,8,4,4,"High",1,1
"3756",22,183,0,1.9282,12,13,2,3,3,2,5,2,4,"High",-1,1
"3757",22,184,1,0.89872,96,7,7,3,2,1,3,2,4,"Low",4,4
"3758",22,185,0,1.2378,50,71,4,4,4,3,7,3,4,"High",0,0
"3759",22,186,1,1.2142,49,94,5,2,4,4,8,4,4,"High",3,3
"3760",22,187,1,1.2171,16,7,4,3,4,2,6,4,4,"High",1,1
"3761",22,188,1,0.67973,60,33,4,1,3,1,4,3,4,"Low",3,3
"3762",22,189,0,2.3484,88,60,4,4,3,4,7,4,4,"High",0,0
"3763",22,190,0,0.70284,91,56,1,4,4,2,6,2,4,"High",-3,3
"3764",22,191,1,0.65651,100,85,6,3,4,2,6,4,4,"High",3,3
"3765",22,192,1,1.086,87,4,4,3,4,1,5,4,4,"High",1,1
"3766",22,193,1,0.9054,80,122,4,1,3,1,4,3,4,"Low",3,3
"3767",22,194,1,0.70077,56,13,4,3,3,3,6,3,4,"High",1,1
"3768",22,195,0,0.88935,4,32,3,3,2,3,5,3,4,"High",0,0
"3769",22,196,1,1.5223,37,33,2,1,3,2,5,3,4,"High",1,1
"3770",22,197,0,1.5808,122,113,1,3,2,2,4,2,4,"Low",-2,2
"3771",22,198,0,1.0446,37,24,2,1,4,4,8,4,4,"High",1,1
"3772",22,199,1,1.202,137,85,2,3,4,3,7,4,4,"High",-1,1
"3773",22,200,0,1.6598,45,143,3,3,2,2,4,2,4,"Low",0,0
"3774",23,1,1,2.5963,67,146,9,5,0,0,0,0,4,"Low",4,4
"3775",23,2,1,2.2094,92,26,6,3,0,0,0,0,4,"Low",3,3
"3776",23,3,0,1.0413,27,118,3,8,0,0,0,0,4,"Low",-5,5
"3777",23,4,0,1.6955,20,99,4,9,0,0,0,0,4,"Low",-5,5
"3778",23,5,0,1.5145,141,63,7,4,0,0,0,0,4,"Low",3,3
"3779",23,6,0,0.98766,96,18,2,4,0,0,0,0,4,"Low",-2,2
"3780",23,7,1,4.4711,99,92,9,6,1,1,2,1,4,"Low",3,3
"3781",23,8,0,1.3219,71,133,3,1,0,0,0,0,4,"Low",2,2
"3782",23,9,1,1.1484,25,125,8,5,0,0,0,0,4,"Low",3,3
"3783",23,10,1,0.93572,20,69,4,2,1,0,1,1,4,"Low",2,2
"3784",23,11,0,0.7817,71,112,3,6,1,0,1,0,4,"Low",-3,3
"3785",23,12,1,2.3004,112,50,6,3,1,0,1,1,4,"Low",3,3
"3786",23,13,0,1.2869,94,117,4,6,0,0,0,0,4,"Low",-2,2
"3787",23,14,0,1.4339,140,33,3,7,0,0,0,0,4,"Low",-4,4
"3788",23,15,1,1.5738,138,97,7,9,0,0,0,0,4,"Low",-2,2
"3789",23,16,0,1.6787,105,146,2,5,0,1,1,1,4,"Low",-3,3
"3790",23,17,0,2.5028,68,17,4,8,0,0,0,0,4,"Low",-4,4
"3791",23,18,1,1.6596,74,129,2,1,0,0,0,0,4,"Low",1,1
"3792",23,19,0,0.92017,112,83,6,10,2,0,2,0,4,"Low",-4,4
"3793",23,20,0,1.2324,18,118,4,8,1,1,2,1,4,"Low",-4,4
"3794",23,21,1,1.0034,66,55,8,3,0,0,0,0,4,"Low",5,5
"3795",23,22,0,2.7572,114,100,3,8,0,0,0,0,4,"Low",-5,5
"3796",23,23,0,2.0263,16,137,2,3,0,0,0,0,4,"Low",-1,1
"3797",23,24,0,2.1434,30,74,1,2,0,1,1,1,4,"Low",-1,1
"3798",23,25,1,2.5855,144,96,4,2,0,1,1,0,4,"Low",2,2
"3799",23,26,0,1.8217,51,132,4,3,0,0,0,0,4,"Low",1,1
"3800",23,27,0,5.9352,17,132,8,3,1,1,2,1,4,"Low",5,5
"3801",23,28,0,1.2619,100,41,8,8,1,0,1,0,4,"Low",0,0
"3802",23,29,0,1.5538,104,132,7,3,0,2,2,2,4,"Low",4,4
"3803",23,30,1,1.6353,31,137,1,3,0,1,1,0,4,"Low",-2,2
"3804",23,31,1,1.0814,103,69,3,2,0,1,1,0,4,"Low",1,1
"3805",23,32,0,1.6993,55,112,3,6,1,3,4,3,4,"Low",-3,3
"3806",23,33,0,1.1894,68,104,4,7,1,1,2,1,4,"Low",-3,3
"3807",23,34,0,9.0006,30,35,1,4,1,0,1,0,4,"Low",-3,3
"3808",23,35,0,1.1873,9,105,1,2,0,1,1,1,4,"Low",-1,1
"3809",23,36,1,0.94021,104,26,7,3,2,1,3,2,4,"Low",4,4
"3810",23,37,0,2.1184,63,117,4,6,1,1,2,1,4,"Low",-2,2
"3811",23,38,1,2.3679,114,26,3,3,1,2,3,1,4,"Low",0,0
"3812",23,39,1,0.8623,14,138,10,7,0,1,1,0,4,"Low",3,3
"3813",23,40,0,2.849,26,125,3,5,3,1,4,1,4,"Low",-2,2
"3814",23,41,0,4.9026,38,1,1,2,0,0,0,0,4,"Low",-1,1
"3815",23,42,1,1.5132,113,1,4,2,0,1,1,0,4,"Low",2,2
"3816",23,43,0,1.3276,89,105,2,2,0,2,2,2,4,"Low",0,0
"3817",23,44,1,2.4174,94,129,4,1,1,1,2,1,4,"Low",3,3
"3818",23,45,1,1.1292,122,92,7,6,0,2,2,0,4,"Low",1,1
"3819",23,46,0,1.3515,35,99,4,9,1,2,3,2,4,"Low",-5,5
"3820",23,47,1,1.014,113,47,4,8,1,0,1,1,4,"Low",-4,4
"3821",23,48,1,2.6972,121,46,1,4,0,0,0,0,4,"Low",-3,3
"3822",23,49,0,1.2979,139,146,2,5,0,2,2,2,4,"Low",-3,3
"3823",23,50,0,1.2334,41,65,8,9,1,0,1,0,4,"Low",-1,1
"3824",23,51,1,3.1419,68,71,4,3,2,2,4,2,4,"Low",1,1
"3825",23,52,1,2.1631,133,143,1,2,1,0,1,1,4,"Low",-1,1
"3826",23,53,1,1.3011,118,132,8,3,2,3,5,2,4,"High",5,5
"3827",23,54,0,0.97463,63,41,4,8,2,2,4,2,4,"Low",-4,4
"3828",23,55,1,0.96562,14,41,10,8,1,3,4,1,4,"Low",2,2
"3829",23,56,0,1.1953,96,31,2,1,2,1,3,1,4,"Low",1,1
"3830",23,57,0,1.4543,113,112,4,6,2,4,6,4,4,"High",-2,2
"3831",23,58,1,1.4757,139,96,2,2,1,3,4,1,4,"Low",0,0
"3832",23,59,1,2.5879,96,143,2,2,4,1,5,4,4,"High",0,0
"3833",23,60,0,1.3393,70,92,4,6,0,3,3,3,4,"Low",-2,2
"3834",23,61,0,0.80295,67,84,9,10,1,0,1,0,4,"Low",-1,1
"3835",23,62,1,1.0018,14,138,10,7,2,2,4,2,4,"Low",3,3
"3836",23,63,0,1.5554,55,117,3,6,2,2,4,2,4,"Low",-3,3
"3837",23,64,0,1.2491,27,25,3,8,1,1,2,1,4,"Low",-5,5
"3838",23,65,1,3.5801,113,125,4,5,3,2,5,3,4,"High",-1,1
"3839",23,66,1,1.1169,67,79,9,4,2,0,2,2,4,"Low",5,5
"3840",23,67,0,1.3284,79,113,4,4,1,4,5,4,4,"High",0,0
"3841",23,68,1,1.1104,34,46,4,4,0,1,1,0,4,"Low",0,0
"3842",23,69,0,3.1031,139,134,2,4,2,0,2,0,4,"Low",-2,2
"3843",23,70,0,1.2857,141,140,7,3,1,1,2,1,4,"Low",4,4
"3844",23,71,1,1.6719,66,67,8,9,1,3,4,1,4,"Low",-1,1
"3845",23,72,1,1.1102,98,17,10,8,0,2,2,0,4,"Low",2,2
"3846",23,73,1,1.7866,134,9,4,1,1,1,2,1,4,"Low",3,3
"3847",23,74,0,1.4165,69,117,2,6,2,3,5,3,4,"High",-4,4
"3848",23,75,1,1.0787,16,141,2,7,1,2,3,1,4,"Low",-5,5
"3849",23,76,0,0.965,63,99,4,9,3,3,6,3,4,"High",-5,5
"3850",23,77,0,4.2907,133,55,1,3,2,3,5,3,4,"High",-2,2
"3851",23,78,0,2.0127,45,140,4,3,0,2,2,2,4,"Low",1,1
"3852",23,79,1,1.1175,102,18,6,4,0,2,2,0,4,"Low",2,2
"3853",23,80,1,3.7964,114,9,3,1,2,2,4,2,4,"Low",2,2
"3854",23,81,1,2.9395,89,70,2,4,1,1,2,1,4,"Low",-2,2
"3855",23,82,0,1.1603,146,103,5,3,3,1,4,1,4,"Low",2,2
"3856",23,83,0,2.6825,122,25,7,8,1,2,3,2,4,"Low",-1,1
"3857",23,84,1,3.8038,111,26,2,3,0,4,4,0,4,"Low",-1,1
"3858",23,85,0,2.745,63,68,4,4,4,3,7,3,4,"High",0,0
"3859",23,86,1,2.0584,50,111,3,2,1,1,2,1,4,"Low",1,1
"3860",23,87,0,11.315,146,117,5,6,4,4,8,4,4,"High",-1,1
"3861",23,88,0,3.1413,143,132,2,3,2,4,6,4,4,"High",-1,1
"3862",23,89,0,6.1465,137,133,3,1,2,3,5,3,4,"High",2,2
"3863",23,90,0,2.0817,144,25,4,8,1,3,4,3,4,"Low",-4,4
"3864",23,91,0,2.5206,18,144,4,4,3,2,5,2,4,"High",0,0
"3865",23,92,1,1.0969,20,45,4,4,2,1,3,2,4,"Low",0,0
"3866",23,93,1,1.2323,125,9,5,1,3,3,6,3,4,"High",4,4
"3867",23,94,0,1.1196,71,34,3,4,3,1,4,1,4,"Low",-1,1
"3868",23,95,0,1.641,45,69,4,2,2,3,5,3,4,"High",2,2
"3869",23,96,1,1.645,93,74,2,2,0,2,2,0,4,"Low",0,0
"3870",23,97,0,1.1387,47,14,8,10,1,3,4,3,4,"Low",-2,2
"3871",23,98,0,1.5107,143,114,2,3,3,3,6,3,4,"High",-1,1
"3872",23,99,1,1.318,102,133,6,1,1,4,5,1,4,"High",5,5
"3873",23,100,0,1.1781,94,65,4,9,2,1,3,1,4,"Low",-5,5
"3874",23,101,1,1.2582,100,70,8,4,2,2,4,2,4,"Low",4,4
"3875",23,102,1,2.1427,129,46,1,4,2,2,4,2,4,"Low",-3,3
"3876",23,103,0,0.91914,114,103,3,3,4,2,6,2,4,"High",0,0
"3877",23,104,1,1.8517,41,18,8,4,4,4,8,4,4,"High",4,4
"3878",23,105,1,1.5748,85,30,3,1,0,2,2,0,4,"Low",2,2
"3879",23,106,0,0.86651,65,33,9,7,2,1,3,1,4,"Low",2,2
"3880",23,107,0,2.7616,143,104,2,7,4,3,7,3,4,"High",-5,5
"3881",23,108,0,3.089,71,105,3,2,4,3,7,3,4,"High",1,1
"3882",23,109,1,1.0053,125,89,5,2,4,2,6,4,4,"High",3,3
"3883",23,110,1,1.6618,105,139,2,2,4,3,7,4,4,"High",0,0
"3884",23,111,0,0.86721,70,65,4,9,3,3,6,3,4,"High",-5,5
"3885",23,112,1,0.81771,66,141,8,7,2,3,5,2,4,"High",1,1
"3886",23,113,1,0.83432,92,134,6,4,4,2,6,4,4,"High",2,2
"3887",23,114,1,1.3913,144,111,4,2,3,2,5,3,4,"High",2,2
"3888",23,115,1,1.8765,51,9,4,1,1,4,5,1,4,"High",3,3
"3889",23,116,1,0.96,102,129,6,1,2,3,5,2,4,"High",5,5
"3890",23,117,1,0.85149,87,47,10,8,0,2,2,0,4,"Low",2,2
"3891",23,118,1,1.2129,27,50,3,3,2,2,4,2,4,"Low",0,0
"3892",23,119,1,1.7088,16,29,2,3,2,0,2,2,4,"Low",-1,1
"3893",23,120,1,1.396,51,141,4,7,2,4,6,2,4,"High",-3,3
"3894",23,121,1,1.298,102,65,6,9,3,4,7,3,4,"High",-3,3
"3895",23,122,1,0.98819,25,47,8,8,4,3,7,4,4,"High",0,0
"3896",23,123,1,1.1016,83,67,10,9,1,4,5,1,4,"High",1,1
"3897",23,124,1,0.83063,84,104,10,7,1,4,5,1,4,"High",3,3
"3898",23,125,0,0.84274,30,102,1,6,3,4,7,4,4,"High",-5,5
"3899",23,126,0,1.0347,134,33,4,7,3,2,5,2,4,"High",-3,3
"3900",23,127,1,2.7816,85,129,3,1,1,4,5,1,4,"High",2,2
"3901",23,128,0,1.0372,45,85,4,3,3,2,5,2,4,"High",1,1
"3902",23,129,0,1.1803,30,85,1,3,4,3,7,3,4,"High",-2,2
"3903",23,130,1,1.473,138,66,7,8,3,3,6,3,4,"High",-1,1
"3904",23,131,0,2.2507,99,84,9,10,4,2,6,2,4,"High",-1,1
"3905",23,132,1,1.6477,139,46,2,4,4,3,7,4,4,"High",-2,2
"3906",23,133,1,1.8191,122,55,7,3,2,4,6,2,4,"High",4,4
"3907",23,134,1,2.2893,93,46,2,4,1,4,5,1,4,"High",-2,2
"3908",23,135,0,0.69772,70,103,4,3,4,3,7,3,4,"High",1,1
"3909",23,136,1,3.0406,69,29,2,3,4,1,5,4,4,"High",-1,1
"3910",23,137,1,2.9734,51,121,4,1,3,1,4,3,4,"Low",3,3
"3911",23,138,1,3.9544,68,34,4,4,4,2,6,4,4,"High",0,0
"3912",23,139,1,3.5267,144,134,4,4,4,4,8,4,4,"High",0,0
"3913",23,140,0,0.91184,33,83,7,10,3,2,5,2,4,"High",-3,3
"3914",23,141,0,7.9123,94,1,4,2,3,2,5,2,4,"High",2,2
"3915",23,142,1,1.6354,31,111,1,2,2,3,5,2,4,"High",-1,1
"3916",23,143,0,4.5677,1,51,2,4,3,4,7,4,4,"High",-2,2
"3917",23,144,0,1.8324,47,118,8,8,4,3,7,3,4,"High",0,0
"3918",23,145,1,1.4019,31,111,1,2,3,4,7,3,4,"High",-1,1
"3919",23,146,0,1.5039,35,89,4,2,2,3,5,3,4,"High",2,2
"3920",23,147,1,1.3535,89,45,2,4,4,4,8,4,4,"High",-2,2
"3921",23,148,1,2.4679,93,140,2,3,2,3,5,2,4,"High",-1,1
"3922",23,149,0,1.3834,34,27,4,3,3,3,6,3,4,"High",1,1
"3923",23,150,1,2.1968,79,16,4,2,2,3,5,2,4,"High",2,2
"3924",23,151,1,1.0395,83,97,10,9,3,1,4,3,4,"Low",1,1
"3925",23,152,0,2.4853,17,140,8,3,3,4,7,4,4,"High",5,5
"3926",23,153,1,2.154,74,1,2,2,3,4,7,3,4,"High",0,0
"3927",23,154,1,1.6066,34,74,4,2,4,4,8,4,4,"High",2,2
"3928",23,155,1,1.0716,31,38,1,1,4,1,5,4,4,"High",0,0
"3929",23,156,1,2.1148,84,66,10,8,3,4,7,3,4,"High",2,2
"3930",23,157,0,1.5102,87,83,10,10,1,4,5,4,4,"High",0,0
"3931",23,158,1,0.83148,103,20,3,4,4,3,7,4,4,"High",-1,1
"3932",23,159,1,4.7491,27,137,3,3,4,3,7,4,4,"High",0,0
"3933",23,160,1,2.5644,93,121,2,1,3,2,5,3,4,"High",1,1
"3934",23,161,0,1.5309,100,14,8,10,3,4,7,4,4,"High",-2,2
"3935",23,162,1,0.87571,33,85,7,3,4,4,8,4,4,"High",4,4
"3936",23,163,0,5.4555,121,50,1,3,3,3,6,3,4,"High",-2,2
"3937",23,164,0,0.98827,38,79,1,4,2,3,5,3,4,"High",-3,3
"3938",23,165,1,1.4415,93,35,2,4,4,3,7,4,4,"High",-2,2
"3939",23,166,1,2.668,17,50,8,3,4,4,8,4,4,"High",5,5
"3940",23,167,0,1.4349,137,20,3,4,4,4,8,4,4,"High",-1,1
"3941",23,168,0,1.194,118,138,8,7,4,4,8,4,4,"High",1,1
"3942",23,169,1,3.9814,79,16,4,2,4,4,8,4,4,"High",2,2
"3943",23,170,0,1.2182,100,98,8,10,4,1,5,1,4,"High",-2,2
"3944",23,171,1,1.6094,122,35,7,4,3,4,7,3,4,"High",3,3
"3945",23,172,0,2.5381,29,94,3,4,2,4,6,4,4,"High",-1,1
"3946",23,173,1,3.019,38,29,1,3,3,3,6,3,4,"High",-2,2
"3947",23,174,1,0.99513,87,98,10,10,2,2,4,2,4,"Low",0,0
"3948",23,175,0,3.0034,98,87,10,10,3,3,6,3,4,"High",0,0
"3949",23,176,1,1.3311,84,122,10,7,4,4,8,4,4,"High",3,3
"3950",23,177,0,2.3022,97,98,9,10,2,4,6,4,4,"High",-1,1
"3951",23,178,0,1.2947,38,121,1,1,4,4,8,4,4,"High",0,0
"3952",23,179,1,4.7854,87,97,10,9,4,3,7,4,4,"High",1,1
"3953",24,1,1,1.503,41,36,10,6,0,0,0,0,4,"Low",4,4
"3954",24,2,1,2.4584,2,67,6,10,0,0,0,0,4,"Low",-4,4
"3955",24,3,0,1.7469,85,74,10,10,0,0,0,0,4,"Low",0,0
"3956",24,4,0,1.7232,89,118,7,10,0,0,0,0,4,"Low",-3,3
"3957",24,5,0,1.6633,38,30,6,10,0,0,0,0,4,"Low",-4,4
"3958",24,6,0,1.3544,33,34,10,10,0,0,0,0,4,"Low",0,0
"3959",24,7,1,1.2986,30,76,10,10,1,0,1,1,4,"Low",0,0
"3960",24,8,1,1.3088,32,72,10,10,0,0,0,0,4,"Low",0,0
"3961",24,9,0,1.6387,100,83,10,10,0,0,0,0,4,"Low",0,0
"3962",24,10,1,2.1874,33,135,10,6,1,0,1,1,4,"Low",4,4
"3963",24,11,0,3.098,67,116,10,10,1,0,1,0,4,"Low",0,0
"3964",24,12,0,1.9994,36,24,6,10,1,0,1,0,4,"Low",-4,4
"3965",24,13,1,1.2008,38,43,6,4,1,0,1,1,4,"Low",2,2
"3966",24,14,0,1.4623,57,134,10,10,0,0,0,0,4,"Low",0,0
"3967",24,15,0,2.5214,73,74,10,10,0,1,1,1,4,"Low",0,0
"3968",24,16,1,1.1996,89,83,7,10,1,1,2,1,4,"Low",-3,3
"3969",24,17,0,1.159,17,118,6,10,0,1,1,1,4,"Low",-4,4
"3970",24,18,0,1.9211,72,117,10,10,1,0,1,0,4,"Low",0,0
"3971",24,19,0,1.7136,44,98,4,4,0,0,0,0,4,"Low",0,0
"3972",24,20,1,1.5311,34,45,10,8,1,0,1,1,4,"Low",2,2
"3973",24,21,1,2.7477,98,25,4,4,1,0,1,1,4,"Low",0,0
"3974",24,22,0,1.3583,48,92,6,10,0,0,0,0,4,"Low",-4,4
"3975",24,23,1,1.1335,29,63,10,10,0,0,0,0,4,"Low",0,0
"3976",24,24,0,1.2798,32,45,10,8,1,1,2,1,4,"Low",2,2
"3977",24,25,0,0.74195,2,29,6,10,1,1,2,1,4,"Low",-4,4
"3978",24,26,0,1.1513,38,18,6,10,2,0,2,0,4,"Low",-4,4
"3979",24,27,1,1.3205,45,51,8,10,2,0,2,2,4,"Low",-2,2
"3980",24,28,0,1.182,78,84,4,4,0,0,0,0,4,"Low",0,0
"3981",24,29,1,1.0447,33,77,10,5,2,0,2,2,4,"Low",5,5
"3982",24,30,0,1.4121,130,83,6,10,0,2,2,2,4,"Low",-4,4
"3983",24,31,0,1.1601,51,29,10,10,1,2,3,2,4,"Low",0,0
"3984",24,32,0,1.011,57,41,10,10,1,1,2,1,4,"Low",0,0
"3985",24,33,0,0.85335,54,24,10,10,0,1,1,1,4,"Low",0,0
"3986",24,34,0,1.1776,117,33,10,10,1,3,4,3,4,"Low",0,0
"3987",24,35,0,0.80888,77,118,5,10,1,2,3,2,4,"Low",-5,5
"3988",24,36,0,1.9683,48,1,6,10,1,0,1,0,4,"Low",-4,4
"3989",24,37,1,1.3683,123,76,10,10,0,1,1,0,4,"Low",0,0
"3990",24,38,1,1.0164,84,142,4,2,1,0,1,1,4,"Low",2,2
"3991",24,39,1,1.0191,102,100,10,10,0,1,1,0,4,"Low",0,0
"3992",24,40,1,0.76331,100,130,10,6,2,1,3,2,4,"Low",4,4
"3993",24,41,0,0.78581,18,103,10,10,1,0,1,0,4,"Low",0,0
"3994",24,42,0,1.3059,41,38,10,6,2,3,5,3,4,"High",4,4
"3995",24,43,0,1.2613,79,97,4,4,0,0,0,0,4,"Low",0,0
"3996",24,44,1,1.3764,144,116,10,10,0,1,1,0,4,"Low",0,0
"3997",24,45,1,0.67314,85,119,10,10,1,0,1,1,4,"Low",0,0
"3998",24,46,1,1.0979,105,119,10,10,0,1,1,0,4,"Low",0,0
"3999",24,47,1,0.90073,45,92,8,10,3,1,4,3,4,"Low",-2,2
"4000",24,48,1,1.0486,85,17,10,6,2,1,3,2,4,"Low",4,4
"4001",24,49,1,0.69337,30,33,10,10,2,4,6,2,4,"High",0,0
"4002",24,50,1,1.0926,87,57,10,10,0,2,2,0,4,"Low",0,0
"4003",24,51,0,1.7335,8,2,1,6,0,2,2,2,4,"Low",-5,5
"4004",24,52,0,0.77166,130,85,6,10,2,3,5,3,4,"High",-4,4
"4005",24,53,0,0.74312,72,45,10,8,2,4,6,4,4,"High",2,2
"4006",24,54,0,1.2863,134,49,10,6,1,0,1,0,4,"Low",4,4
"4007",24,55,0,0.8932,87,34,10,10,1,2,3,2,4,"Low",0,0
"4008",24,56,0,1.5426,67,9,10,10,2,0,2,0,4,"Low",0,0
"4009",24,57,0,0.73266,83,112,10,10,3,0,3,0,4,"Low",0,0
"4010",24,58,0,1.49,93,54,10,10,0,1,1,1,4,"Low",0,0
"4011",24,59,0,1.1765,16,104,6,10,0,0,0,0,4,"Low",-4,4
"4012",24,60,0,0.7859,104,139,10,10,1,0,1,0,4,"Low",0,0
"4013",24,61,1,1.7388,97,61,4,4,1,0,1,1,4,"Low",0,0
"4014",24,62,0,1.228,27,87,10,10,0,2,2,2,4,"Low",0,0
"4015",24,63,0,1.6519,57,100,10,10,3,3,6,3,4,"High",0,0
"4016",24,64,0,0.99397,48,123,6,10,2,1,3,1,4,"Low",-4,4
"4017",24,65,1,1.368,67,93,10,10,3,1,4,3,4,"Low",0,0
"4018",24,66,1,1.0544,36,93,6,10,2,2,4,2,4,"Low",-4,4
"4019",24,67,1,1.0367,74,35,10,10,2,0,2,2,4,"Low",0,0
"4020",24,68,1,1.0377,121,117,8,10,0,2,2,0,4,"Low",-2,2
"4021",24,69,1,1.6749,49,88,6,10,1,0,1,1,4,"Low",-4,4
"4022",24,70,1,0.77392,25,77,4,5,1,2,3,1,4,"Low",-1,1
"4023",24,71,0,0.78578,130,51,6,10,3,2,5,2,4,"High",-4,4
"4024",24,72,1,1.1265,89,48,7,6,2,3,5,2,4,"High",1,1
"4025",24,73,0,0.74009,124,25,4,4,0,2,2,2,4,"Low",0,0
"4026",24,74,1,0.88198,49,61,6,4,2,1,3,2,4,"Low",2,2
"4027",24,75,1,0.84366,51,76,10,10,3,2,5,3,4,"High",0,0
"4028",24,76,1,0.72686,85,104,10,10,4,2,6,4,4,"High",0,0
"4029",24,77,1,1.5047,54,92,10,10,2,2,4,2,4,"Low",0,0
"4030",24,78,1,1.1809,141,131,4,2,0,0,0,0,4,"Low",2,2
"4031",24,79,0,0.73166,100,34,10,10,4,3,7,3,4,"High",0,0
"4032",24,80,0,1.0814,105,118,10,10,1,3,4,3,4,"Low",0,0
"4033",24,81,0,1.0621,32,1,10,10,2,1,3,1,4,"Low",0,0
"4034",24,82,0,1.0218,30,49,10,6,3,3,6,3,4,"High",4,4
"4035",24,83,0,0.82547,144,139,10,10,1,1,2,1,4,"Low",0,0
"4036",24,84,0,0.91712,135,102,6,10,1,1,2,1,4,"Low",-4,4
"4037",24,85,1,1.3852,74,29,10,10,3,3,6,3,4,"High",0,0
"4038",24,86,1,0.83836,25,79,4,4,3,1,4,3,4,"Low",0,0
"4039",24,87,1,0.86135,2,116,6,10,3,2,5,3,4,"High",-4,4
"4040",24,88,1,0.73925,41,116,10,10,3,3,6,3,4,"High",0,0
"4041",24,89,1,0.56665,74,117,10,10,4,3,7,4,4,"High",0,0
"4042",24,90,1,0.80378,105,17,10,6,2,2,4,2,4,"Low",4,4
"4043",24,91,1,1.7767,72,57,10,10,3,4,7,3,4,"High",0,0
"4044",24,92,0,0.8365,121,89,8,7,1,3,4,3,4,"Low",1,1
"4045",24,93,0,1.6287,116,18,10,10,4,2,6,2,4,"High",0,0
"4046",24,94,1,1.5248,67,77,10,5,4,3,7,4,4,"High",5,5
"4047",24,95,1,1.1508,54,117,10,10,3,4,7,3,4,"High",0,0
"4048",24,96,1,0.71214,79,142,4,2,2,1,3,2,4,"Low",2,2
"4049",24,97,0,1.4029,54,112,10,10,4,1,5,1,4,"High",0,0
"4050",24,98,0,1.3527,50,89,4,7,0,4,4,4,4,"Low",-3,3
"4051",24,99,1,0.90631,24,1,10,10,2,2,4,2,4,"Low",0,0
"4052",24,100,0,1.3617,77,78,5,4,4,1,5,1,4,"High",1,1
"4053",24,101,0,0.8859,72,49,10,6,4,4,8,4,4,"High",4,4
"4054",24,102,0,0.79131,135,41,6,10,2,4,6,4,4,"High",-4,4
"4055",24,103,1,0.7665,16,142,6,2,1,2,3,1,4,"Low",4,4
"4056",24,104,0,0.90088,22,2,1,6,0,4,4,4,4,"Low",-5,5
"4057",24,105,1,0.846,97,22,4,1,2,1,3,2,4,"Low",3,3
"4058",24,106,1,0.65616,1,119,10,10,3,2,5,3,4,"High",0,0
"4059",24,107,1,1.1008,30,134,10,10,4,2,6,4,4,"High",0,0
"4060",24,108,1,0.8554,134,118,10,10,3,4,7,3,4,"High",0,0
"4061",24,109,1,0.81965,36,27,6,10,3,1,4,3,4,"Low",-4,4
"4062",24,110,1,0.62224,36,141,6,4,4,1,5,4,4,"High",2,2
"4063",24,111,0,1.5634,131,82,2,4,1,0,1,0,4,"Low",-2,2
"4064",24,112,0,0.86695,124,130,4,6,1,4,5,4,4,"High",-2,2
"4065",24,113,1,0.85555,111,18,10,10,0,3,3,0,4,"Low",0,0
"4066",24,114,0,0.92423,105,96,10,10,3,0,3,0,4,"Low",0,0
"4067",24,115,0,1.125,83,96,10,10,4,1,5,1,4,"High",0,0
"4068",24,116,0,0.78163,79,50,4,4,3,1,4,1,4,"Low",0,0
"4069",24,117,0,0.78693,63,29,10,10,1,4,5,4,4,"High",0,0
"4070",24,118,1,1.1217,38,124,6,4,4,2,6,4,4,"High",2,2
"4071",24,119,0,0.76095,123,16,10,6,2,2,4,2,4,"Low",4,4
"4072",24,120,0,1.5999,48,73,6,10,4,1,5,1,4,"High",-4,4
"4073",24,121,0,0.67695,79,25,4,4,4,4,8,4,4,"High",0,0
"4074",24,122,0,0.69784,102,51,10,10,2,4,6,4,4,"High",0,0
"4075",24,123,0,1.0892,32,96,10,10,3,2,5,2,4,"High",0,0
"4076",24,124,0,1.262,103,140,10,10,1,0,1,0,4,"Low",0,0
"4077",24,125,1,0.87047,92,27,10,10,3,2,5,3,4,"High",0,0
"4078",24,126,1,0.9406,78,44,4,4,2,1,3,2,4,"Low",0,0
"4079",24,127,0,0.97129,142,8,2,1,3,1,4,1,4,"Low",1,1
"4080",24,128,0,0.77328,87,92,10,10,3,4,7,4,4,"High",0,0
"4081",24,129,0,1.3346,82,8,4,1,1,2,3,2,4,"Low",3,3
"4082",24,130,0,0.74877,105,134,10,10,4,4,8,4,4,"High",0,0
"4083",24,131,0,0.61419,24,112,10,10,3,2,5,2,4,"High",0,0
"4084",24,132,0,0.70677,96,121,10,8,3,2,5,2,4,"High",2,2
"4085",24,133,1,0.70096,123,63,10,10,3,2,5,3,4,"High",0,0
"4086",24,134,1,1.0854,88,102,10,10,1,3,4,1,4,"Low",0,0
"4087",24,135,0,0.8411,76,123,10,10,3,4,7,4,4,"High",0,0
"4088",24,136,1,0.68632,96,17,10,6,4,3,7,4,4,"High",4,4
"4089",24,137,1,0.66636,121,73,8,10,3,2,5,3,4,"High",-2,2
"4090",24,138,0,0.58183,73,112,10,10,3,3,6,3,4,"High",0,0
"4091",24,139,1,1.0045,121,16,8,6,4,3,7,4,4,"High",2,2
"4092",24,140,0,1.0363,140,88,10,10,1,2,3,2,4,"Low",0,0
"4093",24,141,0,1.2438,104,24,10,10,3,4,7,4,4,"High",0,0
"4094",24,142,1,0.98872,82,17,4,6,2,4,6,2,4,"High",-2,2
"4095",24,143,1,0.61674,50,22,4,1,2,2,4,2,4,"Low",3,3
"4096",24,144,0,0.82183,93,88,10,10,3,3,6,3,4,"High",0,0
"4097",24,145,1,0.84868,44,124,4,4,2,3,5,2,4,"High",0,0
"4098",24,146,0,0.88148,1,73,10,10,4,4,8,4,4,"High",0,0
"4099",24,147,1,0.67594,111,27,10,10,1,3,4,1,4,"Low",0,0
"4100",24,148,1,0.65482,34,144,10,10,4,2,6,4,4,"High",0,0
"4101",24,149,1,1.163,97,131,4,2,3,2,5,3,4,"High",2,2
"4102",24,150,0,0.56872,9,140,10,10,1,2,3,2,4,"Low",0,0
"4103",24,151,0,1.3249,44,84,4,4,3,2,5,2,4,"High",0,0
"4104",24,152,1,1.4123,87,18,10,10,4,4,8,4,4,"High",0,0
"4105",24,153,1,0.7946,98,142,4,2,2,4,6,2,4,"High",2,2
"4106",24,154,1,1.7208,103,102,10,10,2,4,6,2,4,"High",0,0
"4107",24,155,0,1.1077,9,35,10,10,2,1,3,1,4,"Low",0,0
"4108",24,156,1,1.0559,112,111,10,10,4,2,6,4,4,"High",0,0
"4109",24,157,1,0.95534,124,61,4,4,4,2,6,4,4,"High",0,0
"4110",24,158,1,0.74856,111,104,10,10,3,4,7,3,4,"High",0,0
"4111",24,159,0,0.86985,135,84,6,4,3,3,6,3,4,"High",2,2
"4112",24,160,1,0.74888,140,144,10,10,3,3,6,3,4,"High",0,0
"4113",24,161,0,0.82513,22,98,1,4,3,3,6,3,4,"High",-3,3
"4114",24,162,1,1.2336,8,61,1,4,3,3,6,3,4,"High",-3,3
"4115",24,163,1,0.85269,43,98,4,4,1,4,5,1,4,"High",0,0
"4116",24,164,1,0.81823,97,23,4,4,4,0,4,4,4,"Low",0,0
"4117",24,165,1,0.70365,139,16,10,6,2,4,6,2,4,"High",4,4
"4118",24,166,0,0.97677,61,8,4,1,4,4,8,4,4,"High",3,3
"4119",24,167,1,0.83878,144,119,10,10,4,3,7,4,4,"High",0,0
"4120",24,168,0,1.1239,103,140,10,10,3,4,7,4,4,"High",0,0
"4121",24,169,0,0.549,103,35,10,10,4,2,6,2,4,"High",0,0
"4122",24,170,0,0.80575,63,9,10,10,3,3,6,3,4,"High",0,0
"4123",24,171,1,0.81103,84,82,4,4,4,3,7,4,4,"High",0,0
"4124",24,172,0,1.5638,135,131,6,2,4,3,7,3,4,"High",4,4
"4125",24,173,1,0.83321,43,78,4,4,2,3,5,2,4,"High",0,0
"4126",24,174,0,1.0587,44,141,4,4,4,2,6,2,4,"High",0,0
"4127",24,175,1,1.0511,111,93,10,10,4,4,8,4,4,"High",0,0
"4128",24,176,1,0.85917,141,131,4,2,3,4,7,3,4,"High",2,2
"4129",24,177,0,1.1848,22,141,1,4,4,4,8,4,4,"High",-3,3
"4130",24,178,0,0.83775,88,35,10,10,4,3,7,3,4,"High",0,0
"4131",24,179,0,0.57692,119,35,10,10,4,4,8,4,4,"High",0,0
"4132",24,180,1,0.73268,32,63,10,10,4,4,8,4,4,"High",0,0
"4133",24,181,0,0.71262,78,82,4,4,4,4,8,4,4,"High",0,0
"4134",24,182,0,1.0115,23,43,4,4,1,3,4,3,4,"Low",0,0
"4135",24,183,1,0.93742,9,76,10,10,4,4,8,4,4,"High",0,0
"4136",24,184,0,0.82736,23,43,4,4,2,4,6,4,4,"High",0,0
"4137",24,185,0,0.62496,27,139,10,10,4,3,7,3,4,"High",0,0
"4138",25,1,0,1.3008,27,113,7,10,0,0,0,0,3,"Low",-3,3
"4139",25,2,0,1.2245,30,10,1,4,0,0,0,0,3,"Low",-3,3
"4140",25,3,1,1.1737,49,10,5,4,0,1,1,0,3,"Low",1,1
"4141",25,4,0,1.6467,105,114,4,9,0,0,0,0,3,"Low",-5,5
"4142",25,5,0,1.0505,3,137,8,10,0,0,0,0,3,"Low",-2,2
"4143",25,6,1,1.2946,119,140,5,6,0,0,0,0,3,"Low",-1,1
"4144",25,7,0,1.7365,128,96,3,3,0,0,0,0,3,"Low",0,0
"4145",25,8,0,1.64,61,127,2,2,0,0,0,0,3,"Low",0,0
"4146",25,9,1,0.93275,137,132,10,6,1,0,1,1,3,"Low",4,4
"4147",25,10,1,0.97351,137,119,10,5,2,1,3,2,3,"Low",5,5
"4148",25,11,0,1.6782,43,119,3,5,0,2,2,2,3,"Low",-2,2
"4149",25,12,1,2.258,48,47,1,3,0,0,0,0,3,"Low",-2,2
"4150",25,13,0,1.0677,98,31,7,10,0,0,0,0,3,"Low",-3,3
"4151",25,14,1,1.1508,42,97,4,4,0,0,0,0,3,"Low",0,0
"4152",25,15,0,3.0795,4,18,10,8,0,0,0,0,3,"Low",2,2
"4153",25,16,1,1.3789,41,51,2,2,0,0,0,0,3,"Low",0,0
"4154",25,17,1,2.0742,105,85,4,3,1,0,1,1,3,"Low",1,1
"4155",25,18,0,1.2851,53,50,2,3,0,0,0,0,3,"Low",-1,1
"4156",25,19,1,1.2159,128,30,3,1,1,1,2,1,3,"Low",2,2
"4157",25,20,1,1.1252,104,32,7,3,0,0,0,0,3,"Low",4,4
"4158",25,21,1,1.0604,127,51,2,2,1,1,2,1,3,"Low",0,0
"4159",25,22,0,1.8966,67,126,5,6,0,0,0,0,3,"Low",-1,1
"4160",25,23,1,1.1787,1,34,3,1,0,0,0,0,3,"Low",2,2
"4161",25,24,0,1.21,75,3,3,8,0,1,1,1,3,"Low",-5,5
"4162",25,25,0,2.3587,134,66,7,10,0,0,0,0,3,"Low",-3,3
"4163",25,26,1,2.6568,50,16,3,2,1,0,1,1,3,"Low",1,1
"4164",25,27,0,0.91139,56,26,5,10,0,0,0,0,3,"Low",-5,5
"4165",25,28,0,2.6806,6,26,10,10,0,1,1,1,3,"Low",0,0
"4166",25,29,0,0.82005,126,71,6,10,1,0,1,0,3,"Low",-4,4
"4167",25,30,0,0.5103,15,71,5,10,0,1,1,1,3,"Low",-5,5
"4168",25,31,0,1.2547,95,134,4,7,0,1,1,1,3,"Low",-3,3
"4169",25,32,0,1.267,99,104,10,7,0,1,1,1,3,"Low",3,3
"4170",25,33,0,0.75438,56,9,5,3,1,0,1,0,3,"Low",2,2
"4171",25,34,0,0.90624,51,104,2,7,2,2,4,2,3,"High",-5,5
"4172",25,35,0,1.2844,83,1,1,3,0,1,1,1,3,"Low",-2,2
"4173",25,36,1,1.1445,42,100,4,4,1,0,1,1,3,"Low",0,0
"4174",25,37,0,1.0423,144,96,4,3,0,1,1,1,3,"Low",1,1
"4175",25,38,0,1.3212,97,5,4,8,1,0,1,0,3,"Low",-4,4
"4176",25,39,0,1.3432,144,17,4,3,1,0,1,0,3,"Low",1,1
"4177",25,40,0,0.68865,56,140,5,6,2,1,3,1,3,"Low",-1,1
"4178",25,41,1,0.86793,70,134,10,7,0,2,2,0,3,"Low",3,3
"4179",25,42,1,1.542,32,54,3,1,1,0,1,1,3,"Low",2,2
"4180",25,43,0,0.75179,47,55,3,4,1,0,1,0,3,"Low",-1,1
"4181",25,44,0,1.1007,101,4,6,10,0,1,1,1,3,"Low",-4,4
"4182",25,45,1,1.5225,93,50,3,3,0,2,2,0,3,"Low",0,0
"4183",25,46,1,1.1167,9,132,3,6,1,1,2,1,3,"Low",-3,3
"4184",25,47,1,1.165,61,34,2,1,1,1,2,1,3,"Low",1,1
"4185",25,48,1,1.7602,36,76,2,3,0,0,0,0,3,"Low",-1,1
"4186",25,49,0,0.93633,86,9,3,3,0,2,2,2,3,"Low",0,0
"4187",25,50,0,1.2293,6,20,10,10,1,0,1,0,3,"Low",0,0
"4188",25,51,0,0.83693,55,11,4,4,1,0,1,0,3,"Low",0,0
"4189",25,52,0,2.3955,126,38,6,9,2,0,2,0,3,"Low",-3,3
"4190",25,53,0,1.3224,10,115,4,8,2,0,2,0,3,"Low",-4,4
"4191",25,54,1,2.9158,69,139,9,10,0,0,0,0,3,"Low",-1,1
"4192",25,55,1,1.0532,5,18,8,8,1,1,2,1,3,"Low",0,0
"4193",25,56,0,1.6971,127,60,2,4,2,0,2,0,3,"Low",-2,2
"4194",25,57,1,0.84243,5,56,8,5,2,3,5,2,3,"High",3,3
"4195",25,58,0,1.9277,53,136,2,4,1,0,1,0,3,"Low",-2,2
"4196",25,59,0,0.72853,56,75,5,3,4,1,5,1,3,"High",2,2
"4197",25,60,0,1.386,12,17,1,3,0,1,1,1,3,"Low",-2,2
"4198",25,61,1,0.94473,119,36,5,2,3,1,4,3,3,"High",3,3
"4199",25,62,1,0.8893,119,48,5,1,4,1,5,4,3,"High",4,4
"4200",25,63,0,1.4441,128,25,3,3,2,0,2,0,3,"Low",0,0
"4201",25,64,0,0.80861,132,104,6,7,2,3,5,3,3,"High",-1,1
"4202",25,65,1,1.5909,36,10,2,4,2,3,5,2,3,"High",-2,2
"4203",25,66,0,0.96537,5,68,8,10,3,0,3,0,3,"Low",-2,2
"4204",25,67,1,0.7007,85,47,3,3,1,2,3,1,3,"Low",0,0
"4205",25,68,1,1.5988,126,10,6,4,3,4,7,3,3,"High",2,2
"4206",25,69,1,1.4689,66,101,10,6,1,1,2,1,3,"Low",4,4
"4207",25,70,0,1.0403,51,16,2,2,3,1,4,1,3,"High",0,0
"4208",25,71,1,1.2455,49,84,5,1,1,0,1,1,3,"Low",4,4
"4209",25,72,1,0.71913,117,47,3,3,0,3,3,0,3,"Low",0,0
"4210",25,73,1,1.2382,122,67,9,5,0,1,1,0,3,"Low",4,4
"4211",25,74,0,0.86056,126,123,6,10,4,0,4,0,3,"High",-4,4
"4212",25,75,0,2.0724,99,98,10,7,1,1,2,1,3,"Low",3,3
"4213",25,76,0,1.4842,98,62,7,10,2,0,2,0,3,"Low",-3,3
"4214",25,77,1,0.71919,134,136,7,4,3,1,4,3,3,"High",3,3
"4215",25,78,0,0.81655,98,114,7,9,3,1,4,1,3,"High",-2,2
"4216",25,79,0,0.63767,83,67,1,5,1,2,3,2,3,"Low",-4,4
"4217",25,80,1,0.6151,32,107,3,3,2,0,2,2,3,"Low",0,0
"4218",25,81,1,0.87194,53,142,2,2,2,0,2,2,3,"Low",0,0
"4219",25,82,1,1.2032,142,34,2,1,1,2,3,1,3,"Low",1,1
"4220",25,83,0,0.59346,16,104,2,7,2,4,6,4,3,"High",-5,5
"4221",25,84,0,1.304,27,69,7,9,1,1,2,1,3,"Low",-2,2
"4222",25,85,0,1.2658,144,96,4,3,2,2,4,2,3,"High",1,1
"4223",25,86,0,1.5875,60,17,4,3,1,2,3,2,3,"Low",1,1
"4224",25,87,1,1.1939,21,140,10,6,0,2,2,0,3,"Low",4,4
"4225",25,88,0,0.83623,5,123,8,10,4,1,5,1,3,"High",-2,2
"4226",25,89,1,1.0841,9,34,3,1,3,3,6,3,3,"High",2,2
"4227",25,90,0,1.4434,39,142,3,2,0,2,2,2,3,"Low",1,1
"4228",25,91,1,0.68032,118,54,4,1,0,1,1,0,3,"Low",3,3
"4229",25,92,1,0.9028,39,77,3,3,1,0,1,1,3,"Low",0,0
"4230",25,93,1,1.4085,50,102,3,2,3,0,3,3,3,"Low",1,1
"4231",25,94,0,0.72117,47,105,3,4,4,2,6,2,3,"High",-1,1
"4232",25,95,1,1.0395,32,128,3,3,3,3,6,3,3,"High",0,0
"4233",25,96,0,1.2043,127,39,2,3,3,2,5,2,3,"High",-1,1
"4234",25,97,1,0.49829,27,26,7,10,2,2,4,2,3,"High",-3,3
"4235",25,98,0,1.3393,46,105,1,4,0,3,3,3,3,"Low",-3,3
"4236",25,99,0,0.62629,83,77,1,3,2,1,3,1,3,"Low",-2,2
"4237",25,100,0,1.1435,54,9,1,3,2,4,6,4,3,"High",-2,2
"4238",25,101,0,1.029,15,53,5,2,1,3,4,3,3,"High",3,3
"4239",25,102,1,3.6265,145,52,6,3,0,0,0,0,3,"Low",3,3
"4240",25,103,0,0.64195,138,26,9,10,0,3,3,3,3,"Low",-1,1
"4241",25,104,0,1.6792,132,76,6,3,3,1,4,1,3,"High",3,3
"4242",25,105,0,1.2419,49,27,5,7,2,3,5,3,3,"High",-2,2
"4243",25,106,0,1.0208,14,39,7,3,0,3,3,3,3,"Low",4,4
"4244",25,107,1,1.2107,93,25,3,3,1,1,2,1,3,"Low",0,0
"4245",25,108,0,1.026,77,42,3,4,2,2,4,2,3,"High",-1,1
"4246",25,109,1,0.64761,86,46,3,1,1,1,2,1,3,"Low",2,2
"4247",25,110,0,0.58739,144,100,4,4,3,1,4,1,3,"High",0,0
"4248",25,111,0,1.4583,94,31,5,10,0,1,1,1,3,"Low",-5,5
"4249",25,112,1,1.3344,33,101,7,6,0,2,2,0,3,"Low",1,1
"4250",25,113,0,0.62308,15,17,5,3,2,3,5,3,3,"High",2,2
"4251",25,114,0,1.7258,16,132,2,6,3,4,7,4,3,"High",-4,4
"4252",25,115,0,1.2332,16,42,2,4,4,3,7,3,3,"High",-2,2
"4253",25,116,0,0.94225,100,18,4,8,2,2,4,2,3,"High",-4,4
"4254",25,117,0,0.63757,11,114,4,9,1,2,3,2,3,"Low",-5,5
"4255",25,118,0,0.76055,76,115,3,8,2,1,3,1,3,"Low",-5,5
"4256",25,119,1,0.71387,115,140,8,6,2,3,5,2,3,"High",2,2
"4257",25,120,0,0.85899,60,53,4,2,2,4,6,4,3,"High",2,2
"4258",25,121,1,1.0098,96,25,3,3,3,2,5,3,3,"High",0,0
"4259",25,122,0,1.1494,86,32,3,3,2,4,6,4,3,"High",0,0
"4260",25,123,0,1.162,102,128,2,3,1,4,5,4,3,"High",-1,1
"4261",25,124,0,0.74795,144,105,4,4,4,4,8,4,3,"High",0,0
"4262",25,125,1,0.66068,3,76,8,3,2,3,5,2,3,"High",5,5
"4263",25,126,0,0.49656,120,142,2,2,0,3,3,3,3,"Low",0,0
"4264",25,127,1,0.92084,69,134,9,7,2,4,6,2,3,"High",2,2
"4265",25,128,1,0.99506,94,84,5,1,1,1,2,1,3,"Low",4,4
"4266",25,129,0,1.0381,25,127,3,2,3,4,7,4,3,"High",1,1
"4267",25,130,1,0.77686,36,11,2,4,3,2,5,3,3,"High",-2,2
"4268",25,131,0,1.0035,46,67,1,5,2,3,5,3,3,"High",-4,4
"4269",25,132,0,1.0408,99,98,10,7,2,4,6,4,3,"High",3,3
"4270",25,133,0,0.84752,55,136,4,4,2,2,4,2,3,"High",0,0
"4271",25,134,0,0.83181,38,26,9,10,1,4,5,4,3,"High",-1,1
"4272",25,135,1,1.2489,120,1,2,3,1,2,3,1,3,"Low",-1,1
"4273",25,136,0,0.74964,15,122,5,9,3,1,4,1,3,"High",-4,4
"4274",25,137,1,1.0597,43,83,3,1,1,3,4,1,3,"High",2,2
"4275",25,138,1,1.9478,25,61,3,2,4,2,6,4,3,"High",1,1
"4276",25,139,1,1.0298,94,83,5,1,2,4,6,2,3,"High",4,4
"4277",25,140,1,0.75793,33,69,7,9,1,3,4,1,3,"High",-2,2
"4278",25,141,0,0.75328,61,49,2,5,3,3,6,3,3,"High",-3,3
"4279",25,142,1,1.7419,140,50,6,3,4,4,8,4,3,"High",3,3
"4280",25,143,1,0.8794,78,52,4,3,0,1,1,0,3,"Low",1,1
"4281",25,144,1,1.0159,97,95,4,4,2,1,3,2,3,"Low",0,0
"4282",25,145,0,0.5814,15,18,5,8,4,3,7,3,3,"High",-3,3
"4283",25,146,0,0.74352,6,123,10,10,2,2,4,2,3,"High",0,0
"4284",25,147,0,1.4256,85,17,3,3,2,4,6,4,3,"High",0,0
"4285",25,148,0,1.1509,48,11,1,4,2,3,5,3,3,"High",-3,3
"4286",25,149,0,1.0528,107,77,3,3,1,3,4,3,3,"High",0,0
"4287",25,150,1,0.7516,42,52,4,3,4,2,6,4,3,"High",1,1
"4288",25,151,1,1.0004,136,30,4,1,3,2,5,3,3,"High",3,3
"4289",25,152,1,0.71843,18,100,8,4,4,3,7,4,3,"High",4,4
"4290",25,153,0,0.70166,65,38,10,9,0,2,2,2,3,"Low",1,1
"4291",25,154,1,1.0011,58,61,7,2,0,4,4,0,3,"High",5,5
"4292",25,155,0,0.74774,12,76,1,3,1,4,5,4,3,"High",-2,2
"4293",25,156,1,1.0265,6,94,10,5,3,3,6,3,3,"High",5,5
"4294",25,157,0,1.0477,54,136,1,4,3,4,7,4,3,"High",-3,3
"4295",25,158,0,1.1143,62,122,10,9,1,2,3,2,3,"Low",1,1
"4296",25,159,1,0.78576,114,81,9,9,3,0,3,3,3,"Low",0,0
"4297",25,160,0,0.60585,21,62,10,10,1,2,3,2,3,"Low",0,0
"4298",25,161,0,0.96194,41,33,2,7,1,2,3,2,3,"Low",-5,5
"4299",25,162,1,1.1629,115,66,8,10,3,2,5,3,3,"High",-2,2
"4300",25,163,0,0.72924,66,113,10,10,3,1,4,1,3,"High",0,0
"4301",25,164,1,0.73546,78,30,4,1,1,3,4,1,3,"High",3,3
"4302",25,165,1,0.99853,3,66,8,10,3,4,7,3,3,"High",-2,2
"4303",25,166,0,0.77928,55,142,4,2,3,4,7,4,3,"High",2,2
"4304",25,167,1,1.0782,138,81,9,9,1,1,2,1,3,"Low",0,0
"4305",25,168,1,0.70332,7,67,10,5,0,4,4,0,3,"High",5,5
"4306",25,169,1,0.58891,77,54,3,1,4,4,8,4,3,"High",2,2
"4307",25,170,1,0.66901,68,81,10,9,1,2,3,1,3,"Low",1,1
"4308",25,171,1,1.0401,120,86,2,3,2,3,5,2,3,"High",-1,1
"4309",25,172,0,0.68506,51,143,2,6,4,0,4,0,3,"High",-4,4
"4310",25,173,0,0.81314,102,49,2,5,2,4,6,4,3,"High",-3,3
"4311",25,174,0,0.85846,46,84,1,1,3,2,5,2,3,"High",0,0
"4312",25,175,0,1.0676,143,115,6,8,1,4,5,4,3,"High",-2,2
"4313",25,176,0,1.079,62,27,10,7,3,4,7,4,3,"High",3,3
"4314",25,177,1,0.78427,48,84,1,1,3,3,6,3,3,"High",0,0
"4315",25,178,0,1.5032,69,137,9,10,4,3,7,3,3,"High",-1,1
"4316",25,179,1,0.92177,3,100,8,4,4,4,8,4,3,"High",4,4
"4317",25,180,0,0.96437,95,122,4,9,2,3,5,3,3,"High",-5,5
"4318",25,181,1,1.492,70,62,10,10,1,4,5,1,3,"High",0,0
"4319",25,182,1,0.76876,78,13,4,4,2,0,2,2,3,"Low",0,0
"4320",25,183,1,0.77209,97,52,4,3,3,3,6,3,3,"High",1,1
"4321",25,184,1,0.65234,78,12,4,1,3,2,5,3,3,"High",3,3
"4322",25,185,1,3.5269,139,6,10,10,1,4,5,1,3,"High",0,0
"4323",25,186,1,1.025,97,81,4,9,4,3,7,4,3,"High",-5,5
"4324",25,187,1,0.80632,123,21,10,10,3,2,5,3,3,"High",0,0
"4325",25,188,1,1.3004,13,60,4,4,1,3,4,1,3,"High",0,0
"4326",25,189,1,1.0857,93,95,3,4,2,3,5,2,3,"High",-1,1
"4327",25,190,1,0.84103,21,4,10,10,3,2,5,3,3,"High",0,0
"4328",25,191,1,0.96915,70,4,10,10,2,3,5,2,3,"High",0,0
"4329",25,192,1,1.0178,55,1,4,3,4,3,7,4,3,"High",1,1
"4330",25,193,0,1.8525,48,94,1,5,4,4,8,4,3,"High",-4,4
"4331",25,194,1,1.068,39,13,3,4,4,2,6,4,3,"High",-1,1
"4332",25,195,0,0.74443,34,118,1,4,4,1,5,1,3,"High",-3,3
"4333",25,196,1,2.3218,96,120,3,2,4,3,7,4,3,"High",1,1
"4334",25,197,1,0.89192,122,14,9,7,4,1,5,4,3,"High",2,2
"4335",25,198,0,0.83655,81,139,9,10,4,2,6,2,3,"High",-1,1
"4336",25,199,0,0.80132,11,33,4,7,4,3,7,3,3,"High",-3,3
"4337",25,200,1,1.0324,36,46,2,1,4,4,8,4,3,"High",1,1
"4338",26,1,0,0.93613,143,134,5,7,0,0,0,0,3,"Low",-2,2
"4339",26,2,1,0.78457,97,25,10,9,0,0,0,0,3,"Low",1,1
"4340",26,3,0,0.77521,13,88,2,5,0,0,0,0,3,"Low",-3,3
"4341",26,4,0,1.2133,17,91,2,5,0,0,0,0,3,"Low",-3,3
"4342",26,5,1,1.4259,141,43,8,4,0,0,0,0,3,"Low",4,4
"4343",26,6,0,3.1172,124,77,5,4,0,0,0,0,3,"Low",1,1
"4344",26,7,1,0.91716,113,106,10,5,0,0,0,0,3,"Low",5,5
"4345",26,8,1,0.80465,134,53,7,4,1,0,1,1,3,"Low",3,3
"4346",26,9,0,0.66398,26,1,6,8,0,0,0,0,3,"Low",-2,2
"4347",26,10,1,1.1787,87,116,7,2,0,0,0,0,3,"Low",5,5
"4348",26,11,0,0.9942,110,86,3,5,0,0,0,0,3,"Low",-2,2
"4349",26,12,0,0.86438,89,50,4,7,0,0,0,0,3,"Low",-3,3
"4350",26,13,0,0.86756,132,85,10,10,0,0,0,0,3,"Low",0,0
"4351",26,14,1,1.2756,65,98,10,10,0,0,0,0,3,"Low",0,0
"4352",26,15,1,1.181,117,4,2,1,0,0,0,0,3,"Low",1,1
"4353",26,16,1,1.2005,39,7,4,2,0,0,0,0,3,"Low",2,2
"4354",26,17,0,1.7957,33,15,5,2,0,0,0,0,3,"Low",3,3
"4355",26,18,0,0.82994,87,41,7,10,1,0,1,0,3,"Low",-3,3
"4356",26,19,1,1.4454,86,63,5,7,1,0,1,1,3,"Low",-2,2
"4357",26,20,1,1.7091,130,67,5,1,0,0,0,0,3,"Low",4,4
"4358",26,21,1,1.8407,47,82,5,3,0,0,0,0,3,"Low",2,2
"4359",26,22,0,1.6113,146,33,2,5,0,1,1,1,3,"Low",-3,3
"4360",26,23,1,1.8565,130,75,5,1,1,0,1,1,3,"Low",4,4
"4361",26,24,1,2.7579,43,112,4,4,1,0,1,1,3,"Low",0,0
"4362",26,25,1,1.4216,85,2,10,8,1,0,1,1,3,"Low",2,2
"4363",26,26,1,4.2202,88,128,5,3,1,0,1,1,3,"Low",2,2
"4364",26,27,1,1.2501,33,47,5,5,2,1,3,2,3,"Low",0,0
"4365",26,28,0,1.6162,62,106,2,5,0,1,1,1,3,"Low",-3,3
"4366",26,29,0,1.6736,34,110,5,3,0,1,1,1,3,"Low",2,2
"4367",26,30,1,1.3878,51,62,7,2,0,1,1,0,3,"Low",5,5
"4368",26,31,0,1.1299,77,44,4,4,1,0,1,0,3,"Low",0,0
"4369",26,32,0,1.2248,47,66,5,10,2,0,2,0,3,"Low",-5,5
"4370",26,33,1,1.0667,4,27,1,3,1,0,1,1,3,"Low",-2,2
"4371",26,34,0,1.4118,47,31,5,5,3,0,3,0,3,"Low",0,0
"4372",26,35,1,1.1087,39,102,4,3,1,0,1,1,3,"Low",1,1
"4373",26,36,1,2.4793,86,17,5,2,2,1,3,2,3,"Low",3,3
"4374",26,37,0,2.3438,123,34,4,5,0,1,1,1,3,"Low",-1,1
"4375",26,38,0,1.1063,46,65,5,10,0,1,1,1,3,"Low",-5,5
"4376",26,39,0,1.2373,63,2,7,8,1,1,2,1,3,"Low",-1,1
"4377",26,40,0,0.96824,78,1,3,8,0,1,1,1,3,"Low",-5,5
"4378",26,41,1,1.9354,2,25,8,9,2,1,3,2,3,"Low",-1,1
"4379",26,42,0,1.2396,31,2,5,8,1,3,4,3,3,"High",-3,3
"4380",26,43,1,1.1645,14,123,8,4,0,1,1,0,3,"Low",4,4
"4381",26,44,1,1.0758,113,96,10,9,1,0,1,1,3,"Low",1,1
"4382",26,45,0,1.3404,82,130,3,5,1,2,3,2,3,"Low",-2,2
"4383",26,46,0,1.1365,34,55,5,10,2,0,2,0,3,"Low",-5,5
"4384",26,47,0,2.0903,124,52,5,5,1,0,1,0,3,"Low",0,0
"4385",26,48,1,1.319,7,75,2,1,1,1,2,1,3,"Low",1,1
"4386",26,49,0,0.99549,86,90,5,7,3,0,3,0,3,"Low",-2,2
"4387",26,50,1,1.1587,47,62,5,2,4,2,6,4,3,"High",3,3
"4388",26,51,0,1.0126,20,113,5,10,0,2,2,2,3,"Low",-5,5
"4389",26,52,1,1.2998,26,39,6,4,1,2,3,1,3,"Low",2,2
"4390",26,53,0,1.2189,117,134,2,7,1,2,3,2,3,"Low",-5,5
"4391",26,54,0,0.83993,8,33,3,5,0,3,3,3,3,"Low",-2,2
"4392",26,55,1,2.1847,67,21,1,3,1,0,1,1,3,"Low",-2,2
"4393",26,56,1,1.4443,91,104,5,5,1,0,1,1,3,"Low",0,0
"4394",26,57,0,1.582,78,51,3,7,1,1,2,1,3,"Low",-4,4
"4395",26,58,0,1.7881,137,105,4,6,0,0,0,0,3,"Low",-2,2
"4396",26,59,1,1.4883,34,123,5,4,3,2,5,3,3,"High",1,1
"4397",26,60,0,1.3897,10,31,4,5,0,2,2,2,3,"Low",-1,1
"4398",26,61,1,1.0102,78,53,3,4,2,1,3,2,3,"Low",-1,1
"4399",26,62,1,1.3885,101,17,5,2,0,2,2,0,3,"Low",3,3
"4400",26,63,1,1.0329,79,16,9,6,0,0,0,0,3,"Low",3,3
"4401",26,64,0,1.0039,75,8,1,3,2,1,3,1,3,"Low",-2,2
"4402",26,65,0,1.2639,46,26,5,6,1,2,3,2,3,"Low",-1,1
"4403",26,66,1,1.308,90,78,7,3,1,3,4,1,3,"High",4,4
"4404",26,67,1,1.4366,82,40,3,1,2,0,2,2,3,"Low",2,2
"4405",26,68,1,2.1347,50,30,7,3,1,0,1,1,3,"Low",4,4
"4406",26,69,1,1.0786,32,53,3,4,0,2,2,0,3,"Low",-1,1
"4407",26,70,0,1.2145,82,16,3,6,3,1,4,1,3,"High",-3,3
"4408",26,71,1,0.95931,63,110,7,3,2,2,4,2,3,"High",4,4
"4409",26,72,0,1.2268,90,41,7,10,2,1,3,1,3,"Low",-3,3
"4410",26,73,1,2.7627,94,27,3,3,0,1,1,0,3,"Low",0,0
"4411",26,74,0,1.0416,4,118,1,3,2,0,2,0,3,"Low",-2,2
"4412",26,75,0,1.7022,91,79,5,9,2,1,3,1,3,"Low",-4,4
"4413",26,76,1,0.98288,122,30,8,3,0,1,1,0,3,"Low",5,5
"4414",26,77,0,1.3324,13,52,2,5,1,1,2,1,3,"Low",-3,3
"4415",26,78,0,1.1678,70,82,2,3,0,4,4,4,3,"High",-1,1
"4416",26,79,0,1.363,16,25,6,9,2,2,4,2,3,"High",-3,3
"4417",26,80,0,1.7245,69,30,2,3,0,2,2,2,3,"Low",-1,1
"4418",26,81,1,3.549,10,62,4,2,1,3,4,1,3,"High",2,2
"4419",26,82,1,1.1045,88,75,5,1,2,3,5,2,3,"High",4,4
"4420",26,83,1,1.2337,130,7,5,2,3,2,5,3,3,"High",3,3
"4421",26,84,0,1.1354,141,2,8,8,1,4,5,4,3,"High",0,0
"4422",26,85,0,1.4766,14,65,8,10,1,2,3,2,3,"Low",-2,2
"4423",26,86,0,1.4821,102,110,3,3,1,3,4,3,3,"High",0,0
"4424",26,87,0,1.7159,8,116,3,2,2,1,3,1,3,"Low",1,1
"4425",26,88,1,1.1667,44,146,4,2,1,1,2,1,3,"Low",2,2
"4426",26,89,0,1.1029,31,98,5,10,3,1,4,1,3,"High",-5,5
"4427",26,90,1,2.2774,52,3,5,2,2,0,2,2,3,"Low",3,3
"4428",26,91,1,2.4149,1,20,8,5,2,1,3,2,3,"Low",3,3
"4429",26,92,0,0.76294,35,122,6,8,0,1,1,1,3,"Low",-2,2
"4430",26,93,0,3.1995,78,30,3,3,4,3,7,3,3,"High",0,0
"4431",26,94,0,0.74903,126,25,7,9,0,3,3,3,3,"Low",-2,2
"4432",26,95,1,1.0441,85,86,10,5,2,4,6,2,3,"High",5,5
"4433",26,96,0,0.62828,10,25,4,9,2,4,6,4,3,"High",-5,5
"4434",26,97,1,0.73863,26,137,6,4,3,1,4,3,3,"High",2,2
"4435",26,98,1,1.3357,105,89,6,4,1,1,2,1,3,"Low",2,2
"4436",26,99,0,1.0793,53,13,4,2,3,2,5,2,3,"High",2,2
"4437",26,100,0,1.13,13,51,2,7,3,2,5,2,3,"High",-5,5
"4438",26,101,1,0.76864,90,63,7,7,3,3,6,3,3,"High",0,0
"4439",26,102,1,1.1721,116,143,2,5,2,1,3,2,3,"Low",-3,3
"4440",26,103,0,1.5287,14,99,8,10,2,0,2,0,3,"Low",-2,2
"4441",26,104,1,1.8133,14,55,8,10,3,1,4,3,3,"High",-2,2
"4442",26,105,0,1.2893,89,105,4,6,2,2,4,2,3,"High",-2,2
"4443",26,106,1,1.058,39,44,4,4,3,2,5,3,3,"High",0,0
"4444",26,107,0,0.86022,14,122,8,8,4,2,6,2,3,"High",0,0
"4445",26,108,0,1.081,4,21,1,3,3,1,4,1,3,"High",-2,2
"4446",26,109,0,1.1484,140,39,4,4,0,4,4,4,3,"High",0,0
"4447",26,110,0,1.581,68,98,5,10,0,2,2,2,3,"Low",-5,5
"4448",26,111,1,1.9321,10,94,4,3,3,1,4,3,3,"High",1,1
"4449",26,112,0,2.0292,31,141,5,8,4,2,6,2,3,"High",-3,3
"4450",26,113,1,1.2457,105,68,6,5,3,1,4,3,3,"High",1,1
"4451",26,114,0,1.0197,71,90,3,7,0,4,4,4,3,"High",-4,4
"4452",26,115,0,0.956,45,79,5,9,0,2,2,2,3,"Low",-4,4
"4453",26,116,0,1.088,101,130,5,5,1,4,5,4,3,"High",0,0
"4454",26,117,0,0.84817,16,65,6,10,3,3,6,3,3,"High",-4,4
"4455",26,118,1,1.5986,8,40,3,1,3,1,4,3,3,"High",2,2
"4456",26,119,1,3.7585,51,143,7,5,3,2,5,3,3,"High",2,2
"4457",26,120,0,0.83334,8,32,3,3,4,1,5,1,3,"High",0,0
"4458",26,121,1,1.0635,96,68,9,5,1,2,3,1,3,"Low",4,4
"4459",26,122,0,1.1613,147,50,4,7,0,2,2,2,3,"Low",-3,3
"4460",26,123,1,0.84148,114,71,7,3,0,1,1,0,3,"Low",4,4
"4461",26,124,1,0.92947,10,6,4,2,4,0,4,4,3,"High",2,2
"4462",26,125,0,1.3541,45,106,5,5,1,2,3,2,3,"Low",0,0
"4463",26,126,1,0.79902,41,101,10,5,2,2,4,2,3,"High",5,5
"4464",26,127,1,0.85301,133,33,3,5,0,4,4,0,3,"High",-2,2
"4465",26,128,1,0.63083,96,51,9,7,2,4,6,2,3,"High",2,2
"4466",26,129,0,1.0891,87,1,7,8,2,3,5,3,3,"High",-1,1
"4467",26,130,0,1.717,79,93,9,10,3,0,3,0,3,"Low",-1,1
"4468",26,131,0,1.0546,91,113,5,10,3,3,6,3,3,"High",-5,5
"4469",26,132,0,1.5152,104,3,5,2,1,1,2,1,3,"Low",3,3
"4470",26,133,1,2.2372,116,21,2,3,3,2,5,3,3,"High",-1,1
"4471",26,134,1,1.4835,88,27,5,3,3,2,5,3,3,"High",2,2
"4472",26,135,1,1.4821,50,53,7,4,3,4,7,3,3,"High",3,3
"4473",26,136,0,1.771,71,119,3,6,2,0,2,0,3,"Low",-3,3
"4474",26,137,0,0.97696,46,88,5,5,2,4,6,4,3,"High",0,0
"4475",26,138,1,1.0546,18,16,8,6,0,4,4,0,3,"High",2,2
"4476",26,139,0,2.2487,13,104,2,5,4,2,6,2,3,"High",-3,3
"4477",26,140,1,0.76307,129,68,10,5,0,3,3,0,3,"Low",5,5
"4478",26,141,0,0.8515,134,113,7,10,3,4,7,4,3,"High",-3,3
"4479",26,142,1,1.0077,100,106,9,5,0,3,3,0,3,"Low",4,4
"4480",26,143,0,0.9762,70,91,2,5,1,4,5,4,3,"High",-3,3
"4481",26,144,0,1.1005,143,35,5,6,3,1,4,1,3,"High",-1,1
"4482",26,145,0,1.8324,46,21,5,3,3,3,6,3,3,"High",2,2
"4483",26,146,1,3.1217,45,112,5,4,2,1,3,2,3,"Low",1,1
"4484",26,147,0,1.2896,62,77,2,4,4,2,6,2,3,"High",-2,2
"4485",26,148,0,1.0677,35,134,6,7,2,4,6,4,3,"High",-1,1
"4486",26,149,1,1.4753,79,101,9,5,4,3,7,4,3,"High",4,4
"4487",26,150,0,0.66912,96,41,9,10,3,3,6,3,3,"High",-1,1
"4488",26,151,1,1.3387,18,94,8,3,1,2,3,1,3,"Low",5,5
"4489",26,152,1,1.1505,98,141,10,8,3,3,6,3,3,"High",2,2
"4490",26,153,1,2.3793,118,45,3,5,1,3,4,1,3,"High",-2,2
"4491",26,154,1,0.9818,26,69,6,2,4,1,5,4,3,"High",4,4
"4492",26,155,1,1.5595,112,110,4,3,2,4,6,2,3,"High",1,1
"4493",26,156,1,0.87537,65,114,10,7,4,1,5,4,3,"High",3,3
"4494",26,157,0,0.84675,35,122,6,8,3,3,6,3,3,"High",-2,2
"4495",26,158,1,0.8155,96,68,9,5,4,4,8,4,3,"High",4,4
"4496",26,159,1,1.1495,100,43,9,4,1,2,3,1,3,"Low",5,5
"4497",26,160,0,1.5469,118,126,3,7,2,1,3,1,3,"Low",-4,4
"4498",26,161,1,2.1429,147,75,4,1,1,4,5,1,3,"High",3,3
"4499",26,162,1,1.3022,117,6,2,2,2,1,3,2,3,"Low",0,0
"4500",26,163,1,1.4797,112,5,4,2,3,0,3,3,3,"Low",2,2
"4501",26,164,0,1.4005,143,44,5,4,4,3,7,3,3,"High",1,1
"4502",26,165,0,2.2392,40,4,1,1,2,4,6,4,3,"High",0,0
"4503",26,166,0,1.1164,106,144,5,5,4,0,4,0,3,"High",0,0
"4504",26,167,1,1.4644,128,112,3,4,1,4,5,1,3,"High",-1,1
"4505",26,168,1,1.1193,55,35,10,6,2,4,6,2,3,"High",4,4
"4506",26,169,0,0.82213,104,122,5,8,3,4,7,4,3,"High",-3,3
"4507",26,170,1,1.1835,129,132,10,10,1,1,2,1,3,"Low",0,0
"4508",26,171,1,1.6768,146,61,2,1,2,0,2,2,3,"Low",1,1
"4509",26,172,1,1.2183,101,146,5,2,4,3,7,4,3,"High",3,3
"4510",26,173,0,3.6553,44,77,4,4,4,3,7,3,3,"High",0,0
"4511",26,174,0,1.2363,126,98,7,10,2,4,6,4,3,"High",-3,3
"4512",26,175,1,4.4067,77,63,4,7,4,4,8,4,3,"High",-3,3
"4513",26,176,1,6.0121,128,17,3,2,2,3,5,2,3,"High",1,1
"4514",26,177,0,1.0111,52,114,5,7,3,2,5,2,3,"High",-2,2
"4515",26,178,0,1.3327,89,46,4,5,3,4,7,4,3,"High",-1,1
"4516",26,179,1,1.2826,49,45,10,5,0,4,4,0,3,"High",5,5
"4517",26,180,1,1.1573,118,124,3,5,3,2,5,3,3,"High",-2,2
"4518",26,181,0,2.1872,17,12,2,3,4,0,4,0,3,"High",-1,1
"4519",26,182,1,1.7873,116,50,2,7,4,4,8,4,3,"High",-5,5
"4520",26,183,1,1.6786,140,119,4,6,1,1,2,1,3,"Low",-2,2
"4521",26,184,0,1.1822,137,117,4,2,2,3,5,3,3,"High",2,2
"4522",26,185,0,0.88333,147,18,4,8,2,2,4,2,3,"High",-4,4
"4523",26,186,0,2.8428,52,102,5,3,4,2,6,2,3,"High",2,2
"4524",26,187,0,1.228,6,15,2,2,2,1,3,1,3,"Low",0,0
"4525",26,188,0,1.7437,27,6,3,2,3,3,6,3,3,"High",1,1
"4526",26,189,1,1.7894,137,94,4,3,3,3,6,3,3,"High",1,1
"4527",26,190,1,0.85705,18,21,8,3,3,4,7,3,3,"High",5,5
"4528",26,191,1,0.8264,133,137,3,4,1,4,5,1,3,"High",-1,1
"4529",26,192,1,1.1352,32,128,3,3,2,3,5,2,3,"High",0,0
"4530",26,193,1,1.4691,97,99,10,10,1,1,2,1,3,"Low",0,0
"4531",26,194,1,0.74311,129,87,10,7,2,3,5,2,3,"High",3,3
"4532",26,195,0,2.0663,124,146,5,2,3,4,7,4,3,"High",3,3
"4533",26,196,1,1.0126,18,30,8,3,4,4,8,4,3,"High",5,5
"4534",26,197,1,1.2193,104,40,5,1,4,3,7,4,3,"High",4,4
"4535",26,198,0,1.1627,12,105,3,6,1,4,5,4,3,"High",-3,3
"4536",26,199,1,1.4892,85,41,10,10,3,4,7,3,3,"High",0,0
"4537",26,200,0,1.3408,100,132,9,10,2,2,4,2,3,"High",-1,1
"4538",27,1,1,1.8822,117,34,6,9,0,0,0,0,4,"Low",-3,3
"4539",27,2,0,1.5799,66,119,7,10,0,0,0,0,4,"Low",-3,3
"4540",27,3,1,1.1248,83,124,7,2,0,0,0,0,4,"Low",5,5
"4541",27,4,1,2.1914,87,55,10,10,0,0,0,0,4,"Low",0,0
"4542",27,5,1,1.0551,85,100,6,2,0,0,0,0,4,"Low",4,4
"4543",27,6,1,1.3695,129,30,4,7,0,0,0,0,4,"Low",-3,3
"4544",27,7,1,1.2973,74,105,9,6,0,0,0,0,4,"Low",3,3
"4545",27,8,0,1.087,146,57,3,1,0,0,0,0,4,"Low",2,2
"4546",27,9,0,0.75291,124,117,2,6,1,1,2,1,4,"Low",-4,4
"4547",27,10,0,1.7289,32,118,5,8,0,0,0,0,4,"Low",-3,3
"4548",27,11,0,1.1775,101,85,4,6,0,1,1,1,4,"Low",-2,2
"4549",27,12,1,1.3404,84,20,3,8,0,0,0,0,4,"Low",-5,5
"4550",27,13,1,0.89041,97,124,4,2,0,2,2,0,4,"Low",2,2
"4551",27,14,1,1.2304,30,32,7,5,1,1,2,1,4,"Low",2,2
"4552",27,15,0,1.2237,66,25,7,5,1,0,1,0,4,"Low",2,2
"4553",27,16,1,0.85785,32,16,5,5,2,0,2,2,4,"Low",0,0
"4554",27,17,0,1.3412,134,104,8,7,0,0,0,0,4,"Low",1,1
"4555",27,18,0,2.63,101,98,4,3,1,0,1,0,4,"Low",1,1
"4556",27,19,1,1.3054,112,50,8,5,0,0,0,0,4,"Low",3,3
"4557",27,20,1,1.4115,102,91,5,4,0,0,0,0,4,"Low",1,1
"4558",27,21,1,2.1535,57,102,1,5,1,1,2,1,4,"Low",-4,4
"4559",27,22,0,1.2494,18,32,7,5,0,3,3,3,4,"Low",2,2
"4560",27,23,0,1.0049,100,89,2,3,1,0,1,0,4,"Low",-1,1
"4561",27,24,0,0.77557,85,45,6,10,2,0,2,0,4,"Low",-4,4
"4562",27,25,1,1.4535,96,52,3,3,0,0,0,0,4,"Low",0,0
"4563",27,26,0,1.3163,92,30,2,7,0,2,2,2,4,"Low",-5,5
"4564",27,27,0,1.2224,146,133,3,5,1,0,1,0,4,"Low",-2,2
"4565",27,28,1,1.2212,31,83,9,7,0,1,1,0,4,"Low",2,2
"4566",27,29,1,4.7478,65,16,9,5,0,1,1,0,4,"Low",4,4
"4567",27,30,0,1.0483,84,35,3,8,1,0,1,0,4,"Low",-5,5
"4568",27,31,0,2.7992,32,31,5,9,4,1,5,1,4,"High",-4,4
"4569",27,32,1,0.83927,122,140,10,6,0,0,0,0,4,"Low",4,4
"4570",27,33,1,1.5619,144,99,8,6,0,0,0,0,4,"Low",2,2
"4571",27,34,1,1.9706,63,9,10,7,0,0,0,0,4,"Low",3,3
"4572",27,35,0,1.4874,3,83,7,7,0,2,2,2,4,"Low",0,0
"4573",27,36,0,1.4545,144,134,8,8,1,1,2,1,4,"Low",0,0
"4574",27,37,0,0.94352,133,65,5,9,1,1,2,1,4,"Low",-4,4
"4575",27,38,1,1.2082,118,58,8,4,1,0,1,1,4,"Low",4,4
"4576",27,39,0,1.0903,3,52,7,3,1,1,2,1,4,"Low",4,4
"4577",27,40,0,1.1985,67,55,5,10,0,1,1,1,4,"Low",-5,5
"4578",27,41,1,1.9559,138,30,7,7,0,3,3,0,4,"Low",0,0
"4579",27,42,1,1.7854,138,104,7,7,1,1,2,1,4,"Low",0,0
"4580",27,43,0,1.4088,118,73,8,9,2,0,2,0,4,"Low",-1,1
"4581",27,44,0,1.6029,2,117,4,6,0,2,2,2,4,"Low",-2,2
"4582",27,45,1,1.1461,35,112,8,8,1,1,2,1,4,"Low",0,0
"4583",27,46,0,0.82304,118,119,8,10,3,1,4,1,4,"Low",-2,2
"4584",27,47,0,2.5585,129,91,4,4,1,1,2,1,4,"Low",0,0
"4585",27,48,0,2.2032,94,91,4,4,0,2,2,2,4,"Low",0,0
"4586",27,49,1,1.6733,51,133,6,5,0,2,2,0,4,"Low",1,1
"4587",27,50,0,1.07,94,104,4,7,1,2,3,2,4,"Low",-3,3
"4588",27,51,0,1.1155,134,73,8,9,2,1,3,1,4,"Low",-1,1
"4589",27,52,0,0.75824,67,31,5,9,1,2,3,2,4,"Low",-4,4
"4590",27,53,0,1.1036,102,117,5,6,2,3,5,3,4,"High",-1,1
"4591",27,54,0,5.1307,140,33,6,7,1,0,1,0,4,"Low",-1,1
"4592",27,55,1,2.673,85,139,6,7,3,0,3,3,4,"Low",-1,1
"4593",27,56,1,1.8042,90,52,4,3,0,2,2,0,4,"Low",1,1
"4594",27,57,1,1.0038,74,83,9,7,1,3,4,1,4,"Low",2,2
"4595",27,58,1,2.1475,134,50,8,5,3,1,4,3,4,"Low",3,3
"4596",27,59,1,2.1139,117,25,6,5,4,1,5,4,4,"High",1,1
"4597",27,60,1,1.5359,51,16,6,5,1,2,3,1,4,"Low",1,1
"4598",27,61,0,0.9238,146,2,3,4,2,1,3,1,4,"Low",-1,1
"4599",27,62,0,2.0119,138,55,7,10,2,2,4,2,4,"Low",-3,3
"4600",27,63,0,2.1465,118,33,8,7,4,1,5,1,4,"High",1,1
"4601",27,64,0,2.5793,52,94,3,4,3,2,5,2,4,"High",-1,1
"4602",27,65,0,0.91812,124,89,2,3,3,1,4,1,4,"Low",-1,1
"4603",27,66,0,1.4774,90,9,4,7,1,1,2,1,4,"Low",-3,3
"4604",27,67,1,1.1822,134,97,8,4,4,1,5,4,4,"High",4,4
"4605",27,68,1,0.9602,27,90,2,4,0,2,2,0,4,"Low",-2,2
"4606",27,69,0,2.2479,29,84,8,3,0,2,2,2,4,"Low",5,5
"4607",27,70,1,1.6468,31,144,9,8,3,2,5,3,4,"High",1,1
"4608",27,71,0,1.1059,99,84,6,3,1,3,4,3,4,"Low",3,3
"4609",27,72,1,1.4609,138,100,7,2,3,2,5,3,4,"High",5,5
"4610",27,73,1,1.083,33,50,7,5,2,2,4,2,4,"Low",2,2
"4611",27,74,0,2.2765,104,25,7,5,3,2,5,2,4,"High",2,2
"4612",27,75,1,1.1496,104,129,7,4,4,2,6,4,4,"High",3,3
"4613",27,76,0,0.84989,99,139,6,7,2,1,3,1,4,"Low",-1,1
"4614",27,77,0,1.3986,94,140,4,6,3,2,5,2,4,"High",-2,2
"4615",27,78,1,1.2073,1,3,6,7,0,2,2,0,4,"Low",-1,1
"4616",27,79,0,1.4911,102,83,5,7,3,4,7,4,4,"High",-2,2
"4617",27,80,1,0.90667,45,30,10,7,1,4,5,1,4,"High",3,3
"4618",27,81,1,2.826,52,3,3,7,4,3,7,4,4,"High",-4,4
"4619",27,82,0,0.77019,18,45,7,10,1,2,3,2,4,"Low",-3,3
"4620",27,83,0,1.0655,58,18,4,7,1,2,3,2,4,"Low",-3,3
"4621",27,84,1,1.4736,146,25,3,5,3,3,6,3,4,"High",-2,2
"4622",27,85,1,1.0856,51,103,6,1,2,0,2,2,4,"Low",5,5
"4623",27,86,1,1.4177,87,119,10,10,1,2,3,1,4,"Low",0,0
"4624",27,87,0,1.6564,90,41,4,9,3,0,3,0,4,"Low",-5,5
"4625",27,88,0,0.885,41,63,9,10,1,1,2,1,4,"Low",-1,1
"4626",27,89,1,0.80629,87,51,10,6,2,3,5,2,4,"High",4,4
"4627",27,90,1,1.0058,66,58,7,4,2,2,4,2,4,"Low",3,3
"4628",27,91,1,1.6922,73,31,9,9,2,4,6,2,4,"High",0,0
"4629",27,92,1,1.0545,50,101,5,4,3,2,5,3,4,"High",1,1
"4630",27,93,1,2.7072,102,99,5,6,4,3,7,4,4,"High",-1,1
"4631",27,94,1,0.77928,54,3,3,7,0,4,4,0,4,"Low",-4,4
"4632",27,95,1,1.3118,34,50,9,5,1,4,5,1,4,"High",4,4
"4633",27,96,0,1.0579,99,20,6,8,4,1,5,1,4,"High",-2,2
"4634",27,97,0,1.2941,96,138,3,7,1,4,5,4,4,"High",-4,4
"4635",27,98,0,1.2221,2,65,4,9,2,2,4,2,4,"Low",-5,5
"4636",27,99,0,0.81735,2,65,4,9,3,3,6,3,4,"High",-5,5
"4637",27,100,1,1.08,112,133,8,5,2,3,5,2,4,"High",3,3
"4638",27,101,0,0.8569,97,132,4,6,2,0,2,0,4,"Low",-2,2
"4639",27,102,1,0.95891,121,57,4,1,0,2,2,0,4,"Low",3,3
"4640",27,103,0,2.1908,18,63,7,10,3,2,5,2,4,"High",-3,3
"4641",27,104,1,1.0543,41,67,9,5,2,2,4,2,4,"Low",4,4
"4642",27,105,1,0.87517,119,133,10,5,3,4,7,3,4,"High",5,5
"4643",27,106,1,1.167,51,29,6,8,4,1,5,4,4,"High",-2,2
"4644",27,107,0,0.82651,101,27,4,2,3,1,4,1,4,"Low",2,2
"4645",27,108,1,1.0085,9,67,7,5,2,3,5,2,4,"High",2,2
"4646",27,109,1,7.3412,45,46,10,10,3,0,3,3,4,"Low",0,0
"4647",27,110,0,1.2534,16,63,5,10,3,3,6,3,4,"High",-5,5
"4648",27,111,0,3.3797,66,132,7,6,3,1,4,1,4,"Low",1,1
"4649",27,112,0,1.1672,96,121,3,4,2,1,3,1,4,"Low",-1,1
"4650",27,113,1,2.0561,140,65,6,9,3,4,7,3,4,"High",-3,3
"4651",27,114,1,3.7402,129,97,4,4,3,3,6,3,4,"High",0,0
"4652",27,115,0,0.90976,20,105,8,6,2,1,3,1,4,"Low",2,2
"4653",27,116,0,1.1043,97,73,4,9,4,3,7,3,4,"High",-5,5
"4654",27,117,0,0.93742,92,140,2,6,1,4,5,4,4,"High",-4,4
"4655",27,118,1,2.6183,27,105,2,6,2,2,4,2,4,"Low",-4,4
"4656",27,119,0,0.78814,94,16,4,5,4,4,8,4,4,"High",-1,1
"4657",27,120,1,1.3669,9,101,7,4,3,4,7,3,4,"High",3,3
"4658",27,121,0,2.9337,103,89,1,3,1,2,3,2,4,"Low",-2,2
"4659",27,122,0,1.5218,144,74,8,9,3,2,5,2,4,"High",-1,1
"4660",27,123,0,0.72788,20,105,8,6,3,3,6,3,4,"High",2,2
"4661",27,124,1,1.5118,121,2,4,4,2,4,6,2,4,"High",0,0
"4662",27,125,0,0.83073,129,74,4,9,4,3,7,3,4,"High",-5,5
"4663",27,126,1,1.4433,139,98,7,3,2,1,3,2,4,"Low",4,4
"4664",27,127,1,2.4639,132,112,6,8,2,3,5,2,4,"High",-2,2
"4665",27,128,1,3.7793,18,66,7,7,4,4,8,4,4,"High",0,0
"4666",27,129,0,1.1747,67,29,5,8,4,2,6,2,4,"High",-3,3
"4667",27,130,0,0.88491,20,122,8,10,4,1,5,1,4,"High",-2,2
"4668",27,131,0,1.5175,25,29,5,8,4,3,7,3,4,"High",-3,3
"4669",27,132,1,3.1068,58,98,4,3,3,2,5,3,4,"High",1,1
"4670",27,133,0,0.95365,103,105,1,6,2,4,6,4,4,"High",-5,5
"4671",27,134,0,0.95437,92,84,2,3,2,4,6,4,4,"High",-1,1
"4672",27,135,0,0.71185,9,29,7,8,4,4,8,4,4,"High",-1,1
"4673",27,136,0,1.5444,89,146,3,3,3,4,7,4,4,"High",0,0
"4674",27,137,0,0.88172,96,91,3,4,3,3,6,3,4,"High",-1,1
"4675",27,138,0,1.1985,96,139,3,7,4,3,7,3,4,"High",-4,4
"4676",27,139,1,1.5979,54,92,3,2,1,3,4,1,4,"Low",1,1
"4677",27,140,0,1.4633,90,57,4,1,4,3,7,3,4,"High",3,3
"4678",27,141,1,2.3526,27,89,2,3,3,4,7,3,4,"High",-1,1
"4679",27,142,0,0.90933,41,74,9,9,3,4,7,4,4,"High",0,0
"4680",27,143,1,1.2015,119,1,10,6,4,1,5,4,4,"High",4,4
"4681",27,144,1,2.2253,91,98,4,3,4,3,7,4,4,"High",1,1
"4682",27,145,0,0.65601,1,45,6,10,2,4,6,4,4,"High",-4,4
"4683",27,146,0,2.0594,41,35,9,8,4,2,6,2,4,"High",1,1
"4684",27,147,0,0.96166,58,54,4,3,4,2,6,2,4,"High",1,1
"4685",27,148,1,2.4456,132,54,6,3,3,3,6,3,4,"High",3,3
"4686",27,149,0,3.335,112,35,8,8,4,3,7,3,4,"High",0,0
"4687",27,150,0,1.0218,92,1,2,6,4,3,7,3,4,"High",-4,4
"4688",27,151,1,1.5758,132,27,6,2,4,4,8,4,4,"High",4,4
"4689",27,152,1,1.4874,54,144,3,8,4,4,8,4,4,"High",-5,5
"4690",27,153,0,1.148,63,87,10,10,4,3,7,3,4,"High",0,0
"4691",27,154,0,1.7946,55,87,10,10,3,4,7,4,4,"High",0,0
"4692",27,155,0,1.2335,35,55,8,10,4,4,8,4,4,"High",-2,2
"4693",27,156,0,1.6983,1,33,6,7,4,3,7,3,4,"High",-1,1
"4694",27,157,0,1.1002,103,57,1,1,3,4,7,4,4,"High",0,0
"4695",27,158,0,0.93022,98,139,3,7,4,4,8,4,4,"High",-4,4
"4696",27,159,0,0.89694,100,121,2,4,3,3,6,3,4,"High",-2,2
"4697",27,160,0,1.4636,34,73,9,9,2,4,6,4,4,"High",0,0
"4698",27,161,1,1.191,33,124,7,2,4,4,8,4,4,"High",5,5
"4699",27,162,0,1.6052,34,85,9,6,3,4,7,4,4,"High",3,3
"4700",27,163,1,1.0324,122,34,10,9,2,4,6,2,4,"High",1,1
"4701",27,164,1,1.1552,103,100,1,2,4,4,8,4,4,"High",-1,1
"4702",27,165,1,7.8219,46,122,10,10,1,3,4,1,4,"Low",0,0
"4703",27,166,0,2.0372,122,46,10,10,4,2,6,2,4,"High",0,0
"4704",28,1,1,0.93626,121,43,6,2,0,0,0,0,4,"Low",4,4
"4705",28,2,0,1.217,16,83,6,9,0,0,0,0,4,"Low",-3,3
"4706",28,3,0,1.0117,46,20,7,8,0,0,0,0,4,"Low",-1,1
"4707",28,4,0,1.1276,74,36,4,4,0,0,0,0,4,"Low",0,0
"4708",28,5,1,1.0689,45,46,9,7,0,1,1,0,4,"Low",2,2
"4709",28,6,1,0.90914,113,118,9,4,0,0,0,0,4,"Low",5,5
"4710",28,7,0,1.1683,58,32,4,3,0,0,0,0,4,"Low",1,1
"4711",28,8,1,1.8295,36,26,4,1,1,0,1,1,4,"Low",3,3
"4712",28,9,1,1.5232,25,1,8,8,0,0,0,0,4,"Low",0,0
"4713",28,10,1,1.2973,20,1,8,8,1,1,2,1,4,"Low",0,0
"4714",28,11,1,1.1731,65,2,8,3,0,0,0,0,4,"Low",5,5
"4715",28,12,1,1.3767,89,30,6,9,0,0,0,0,4,"Low",-3,3
"4716",28,13,0,1.4835,102,74,2,4,0,1,1,1,4,"Low",-2,2
"4717",28,14,0,1.0099,20,84,8,9,2,0,2,0,4,"Low",-1,1
"4718",28,15,0,1.1329,1,31,8,8,2,0,2,0,4,"Low",0,0
"4719",28,16,1,1.0509,28,141,5,1,0,0,0,0,4,"Low",4,4
"4720",28,17,1,1.9589,59,112,7,10,0,0,0,0,4,"Low",-3,3
"4721",28,18,0,1.0512,112,83,10,9,1,1,2,1,4,"Low",1,1
"4722",28,19,0,1.178,55,85,9,9,0,0,0,0,4,"Low",0,0
"4723",28,20,1,1.6827,25,62,8,5,1,0,1,1,4,"Low",3,3
"4724",28,21,0,1.6569,92,85,6,9,0,1,1,1,4,"Low",-3,3
"4725",28,22,0,2.3476,144,105,4,5,0,0,0,0,4,"Low",-1,1
"4726",28,23,0,1.1295,90,20,4,8,0,3,3,3,4,"Low",-4,4
"4727",28,24,0,1.2827,133,73,5,8,0,0,0,0,4,"Low",-3,3
"4728",28,25,0,1.7024,2,111,3,7,1,0,1,0,4,"Low",-4,4
"4729",28,26,0,1.8785,144,54,4,7,1,0,1,0,4,"Low",-3,3
"4730",28,27,0,1.8159,27,81,2,2,0,0,0,0,4,"Low",0,0
"4731",28,28,0,0.95333,20,87,8,10,4,0,4,0,4,"Low",-2,2
"4732",28,29,1,1.9026,129,2,2,3,0,2,2,0,4,"Low",-1,1
"4733",28,30,1,2.1457,62,51,5,10,1,0,1,1,4,"Low",-5,5
"4734",28,31,0,0.88946,75,52,6,7,0,0,0,0,4,"Low",-1,1
"4735",28,32,0,2.5908,74,111,4,7,2,1,3,1,4,"Low",-3,3
"4736",28,33,1,0.99,81,26,2,1,1,1,2,1,4,"Low",1,1
"4737",28,34,1,1.2238,27,42,2,4,1,0,1,1,4,"Low",-2,2
"4738",28,35,0,2.0158,55,66,9,7,1,0,1,0,4,"Low",2,2
"4739",28,36,1,1.1348,113,73,9,8,1,1,2,1,4,"Low",1,1
"4740",28,37,1,1.209,9,125,3,6,0,0,0,0,4,"Low",-3,3
"4741",28,38,1,1.1297,85,74,9,4,2,3,5,2,4,"High",5,5
"4742",28,39,1,2.3978,88,65,6,8,0,1,1,0,4,"Low",-2,2
"4743",28,40,0,1.3299,2,28,3,5,3,1,4,1,4,"Low",-2,2
"4744",28,41,1,1.717,28,74,5,4,2,4,6,2,4,"High",1,1
"4745",28,42,0,1.1497,46,112,7,10,2,2,4,2,4,"Low",-3,3
"4746",28,43,0,1.1273,129,89,2,6,1,1,2,1,4,"Low",-4,4
"4747",28,44,1,1.3026,133,142,5,3,1,0,1,1,4,"Low",2,2
"4748",28,45,0,1.2066,51,76,10,7,1,0,1,0,4,"Low",3,3
"4749",28,46,0,2.6531,121,117,6,3,1,0,1,0,4,"Low",3,3
"4750",28,47,1,1.2649,146,96,8,6,0,0,0,0,4,"Low",2,2
"4751",28,48,1,1.1321,52,118,7,4,1,1,2,1,4,"Low",3,3
"4752",28,49,0,1.4721,142,43,3,2,1,1,2,1,4,"Low",1,1
"4753",28,50,1,1.0901,113,42,9,4,2,1,3,2,4,"Low",5,5
"4754",28,51,1,0.85759,41,49,10,6,0,0,0,0,4,"Low",4,4
"4755",28,52,0,0.71838,90,31,4,8,1,1,2,1,4,"Low",-4,4
"4756",28,53,0,1.0867,91,21,2,5,0,0,0,0,4,"Low",-3,3
"4757",28,54,0,1.1624,75,123,6,6,1,0,1,0,4,"Low",0,0
"4758",28,55,0,1.5427,88,113,6,9,1,3,4,3,4,"Low",-3,3
"4759",28,56,1,1.3806,59,34,7,9,1,0,1,1,4,"Low",-2,2
"4760",28,57,0,1.2513,133,118,5,4,2,2,4,2,4,"Low",1,1
"4761",28,58,1,1.3898,111,117,7,3,2,1,3,2,4,"Low",4,4
"4762",28,59,1,2.4981,118,54,4,7,3,1,4,3,4,"Low",-3,3
"4763",28,60,0,2.0714,9,46,3,7,1,3,4,3,4,"Low",-4,4
"4764",28,61,0,1.13,46,88,7,6,4,2,6,2,4,"High",1,1
"4765",28,62,1,1.3087,66,63,7,2,1,0,1,1,4,"Low",5,5
"4766",28,63,0,1.3276,54,88,7,6,2,3,5,3,4,"High",1,1
"4767",28,64,0,1.0637,30,146,9,8,1,1,2,1,4,"Low",1,1
"4768",28,65,0,1.0715,88,52,6,7,4,2,6,2,4,"High",-1,1
"4769",28,66,0,1.5757,133,118,5,4,3,4,7,4,4,"High",1,1
"4770",28,67,1,2.6896,90,32,4,3,2,1,3,2,4,"Low",1,1
"4771",28,68,1,1.303,51,30,10,9,2,2,4,2,4,"Low",1,1
"4772",28,69,0,1.055,123,41,6,10,1,1,2,1,4,"Low",-4,4
"4773",28,70,0,1.6979,105,45,5,9,1,1,2,1,4,"Low",-4,4
"4774",28,71,1,1.0978,49,141,6,1,1,1,2,1,4,"Low",5,5
"4775",28,72,1,1.0411,38,2,8,3,0,4,4,0,4,"Low",5,5
"4776",28,73,0,0.8521,75,59,6,7,2,2,4,2,4,"Low",-1,1
"4777",28,74,0,1.0385,90,62,4,5,3,2,5,2,4,"High",-1,1
"4778",28,75,1,1.3933,39,89,8,6,0,2,2,0,4,"Low",2,2
"4779",28,76,0,1.6222,76,112,7,10,1,3,4,3,4,"Low",-3,3
"4780",28,77,0,0.93638,45,146,9,8,2,2,4,2,4,"Low",1,1
"4781",28,78,0,1.5496,76,112,7,10,2,4,6,4,4,"High",-3,3
"4782",28,79,0,1.2223,101,121,1,6,0,2,2,2,4,"Low",-5,5
"4783",28,80,0,1.1263,1,28,8,5,3,3,6,3,4,"High",3,3
"4784",28,81,0,1.3146,58,114,4,2,1,0,1,0,4,"Low",2,2
"4785",28,82,1,1.0273,85,42,9,4,3,2,5,3,4,"High",5,5
"4786",28,83,1,1.3069,146,133,8,5,3,4,7,3,4,"High",3,3
"4787",28,84,0,2.1584,125,90,6,4,1,4,5,4,4,"High",2,2
"4788",28,85,1,1.1751,113,36,9,4,4,2,6,4,4,"High",5,5
"4789",28,86,0,1.4105,69,105,2,5,0,2,2,2,4,"Low",-3,3
"4790",28,87,1,3.045,132,75,6,6,0,3,3,0,4,"Low",0,0
"4791",28,88,1,1.1365,31,132,8,6,2,1,3,2,4,"Low",2,2
"4792",28,89,0,2.0786,114,96,2,6,1,1,2,1,4,"Low",-4,4
"4793",28,90,0,1.8067,92,91,6,2,1,1,2,1,4,"Low",4,4
"4794",28,91,1,1.2125,9,43,3,2,2,2,4,2,4,"Low",1,1
"4795",28,92,0,1.2247,141,36,1,4,2,3,5,3,4,"High",-3,3
"4796",28,93,0,1.4501,75,45,6,9,4,3,7,3,4,"High",-3,3
"4797",28,94,0,1.0928,91,28,2,5,2,4,6,4,4,"High",-3,3
"4798",28,95,0,1.0516,124,96,6,6,0,2,2,2,4,"Low",0,0
"4799",28,96,0,1.2229,55,146,9,8,2,4,6,4,4,"High",1,1
"4800",28,97,1,1.5163,55,51,9,10,3,3,6,3,4,"High",-1,1
"4801",28,98,1,1.0475,65,1,8,8,2,4,6,2,4,"High",0,0
"4802",28,99,0,1.9595,94,32,2,3,0,2,2,2,4,"Low",-1,1
"4803",28,100,0,1.6685,141,91,1,2,3,3,6,3,4,"High",-1,1
"4804",28,101,0,1.9647,73,16,8,6,2,1,3,1,4,"Low",2,2
"4805",28,102,1,0.99749,54,142,7,3,3,2,5,3,4,"High",4,4
"4806",28,103,0,0.85938,142,21,3,5,3,1,4,1,4,"Low",-2,2
"4807",28,104,0,1.1661,101,117,1,3,1,2,3,2,4,"Low",-2,2
"4808",28,105,0,1.4206,31,122,8,10,3,0,3,0,4,"Low",-2,2
"4809",28,106,1,1.135,59,63,7,2,3,1,4,3,4,"Low",5,5
"4810",28,107,0,1.7776,39,25,8,8,1,2,3,2,4,"Low",0,0
"4811",28,108,0,0.97032,63,144,2,4,2,2,4,2,4,"Low",-2,2
"4812",28,109,1,1.2896,122,59,10,7,1,4,5,1,4,"High",3,3
"4813",28,110,1,1.1949,21,30,5,9,2,3,5,2,4,"High",-4,4
"4814",28,111,0,1.3216,141,94,1,2,4,1,5,1,4,"High",-1,1
"4815",28,112,0,1.9817,55,16,9,6,4,2,6,2,4,"High",3,3
"4816",28,113,1,0.76316,122,85,10,9,2,4,6,2,4,"High",1,1
"4817",28,114,1,1.5485,32,142,3,3,3,4,7,3,4,"High",0,0
"4818",28,115,1,1.1566,81,63,2,2,2,3,5,2,4,"High",0,0
"4819",28,116,1,1.1518,31,51,8,10,4,4,8,4,4,"High",-2,2
"4820",28,117,1,0.96847,87,89,10,6,1,3,4,1,4,"Low",4,4
"4821",28,118,1,1.2026,96,27,6,2,3,2,5,3,4,"High",4,4
"4822",28,119,1,0.98605,122,41,10,10,3,2,5,3,4,"High",0,0
"4823",28,120,0,2.2522,121,89,6,6,3,4,7,4,4,"High",0,0
"4824",28,121,1,1.2216,83,49,9,6,2,2,4,2,4,"Low",3,3
"4825",28,122,1,1.5602,25,39,8,8,3,2,5,3,4,"High",0,0
"4826",28,123,0,2.0102,27,104,2,1,3,0,3,0,4,"Low",1,1
"4827",28,124,0,1.1289,129,16,2,6,2,3,5,3,4,"High",-4,4
"4828",28,125,0,0.7775,129,96,2,6,3,4,7,4,4,"High",-4,4
"4829",28,126,1,0.9821,92,42,6,4,2,3,5,2,4,"High",2,2
"4830",28,127,0,1.7704,81,16,2,6,3,4,7,4,4,"High",-4,4
"4831",28,128,1,1.1643,101,92,1,6,2,3,5,2,4,"High",-5,5
"4832",28,129,1,1.283,36,101,4,1,4,3,7,4,4,"High",3,3
"4833",28,130,0,1.1905,58,81,4,2,2,4,6,4,4,"High",2,2
"4834",28,131,1,1.8363,139,57,7,5,0,0,0,0,4,"Low",2,2
"4835",28,132,0,0.86398,30,84,9,9,4,1,5,1,4,"High",0,0
"4836",28,133,0,1.1784,54,76,7,7,4,3,7,3,4,"High",0,0
"4837",28,134,0,1.596,139,52,7,7,1,3,4,3,4,"Low",0,0
"4838",28,135,1,1.1497,39,119,8,3,3,0,3,3,4,"Low",5,5
"4839",28,136,0,1.0975,57,41,5,10,1,3,4,3,4,"Low",-5,5
"4840",28,137,1,1.4272,101,42,1,4,4,4,8,4,4,"High",-3,3
"4841",28,138,1,1.1674,34,139,9,7,1,2,3,1,4,"Low",2,2
"4842",28,139,1,1.8792,132,92,6,6,2,4,6,2,4,"High",0,0
"4843",28,140,0,1.3242,87,122,10,10,2,4,6,4,4,"High",0,0
"4844",28,141,1,1.5542,144,129,4,2,3,4,7,3,4,"High",2,2
"4845",28,142,1,1.3296,39,111,8,7,4,3,7,4,4,"High",1,1
"4846",28,143,1,1.3203,25,117,8,3,4,3,7,4,4,"High",5,5
"4847",28,144,0,1.2449,57,50,5,9,2,0,2,0,4,"Low",-4,4
"4848",28,145,1,1.6037,57,104,5,1,3,1,4,3,4,"Low",4,4
"4849",28,146,0,1.0777,57,38,5,8,4,1,5,1,4,"High",-3,3
"4850",28,147,0,1.109,66,52,7,7,2,4,6,4,4,"High",0,0
"4851",28,148,1,1.7624,34,50,9,9,2,1,3,2,4,"Low",0,0
"4852",28,149,0,1.891,49,35,6,10,3,0,3,0,4,"Low",-4,4
"4853",28,150,1,1.2371,132,63,6,2,3,4,7,3,4,"High",4,4
"4854",28,151,1,0.79229,102,104,2,1,1,2,3,1,4,"Low",1,1
"4855",28,152,0,0.82271,105,9,5,3,3,3,6,3,4,"High",2,2
"4856",28,153,1,1.8876,111,123,7,6,4,2,6,4,4,"High",1,1
"4857",28,154,0,0.86088,32,62,3,5,4,3,7,3,4,"High",-2,2
"4858",28,155,1,1.2191,105,124,5,6,4,1,5,4,4,"High",-1,1
"4859",28,156,1,1.129,21,9,5,3,3,4,7,3,4,"High",2,2
"4860",28,157,1,1.9942,132,144,6,4,4,4,8,4,4,"High",2,2
"4861",28,158,0,1.4862,50,29,9,9,2,0,2,0,4,"Low",0,0
"4862",28,159,1,0.79101,87,29,10,9,3,1,4,3,4,"Low",1,1
"4863",28,160,0,1.0585,94,119,2,3,2,1,3,1,4,"Low",-1,1
"4864",28,161,1,1.2452,123,104,6,1,3,3,6,3,4,"High",5,5
"4865",28,162,1,0.82411,84,139,9,7,2,3,5,2,4,"High",2,2
"4866",28,163,1,1.2031,62,104,5,1,4,4,8,4,4,"High",4,4
"4867",28,164,1,2.2724,125,27,6,2,2,4,6,2,4,"High",4,4
"4868",28,165,0,1.8788,38,76,8,7,2,4,6,4,4,"High",1,1
"4869",28,166,1,1.4008,139,91,7,2,4,4,8,4,4,"High",5,5
"4870",28,167,0,0.90153,124,49,6,6,2,4,6,4,4,"High",0,0
"4871",28,168,0,3.5696,38,123,8,6,3,4,7,4,4,"High",2,2
"4872",28,169,0,0.98106,69,125,2,6,1,3,4,3,4,"Low",-4,4
"4873",28,170,1,0.87493,29,124,9,6,2,3,5,2,4,"High",3,3
"4874",28,171,1,1.1762,73,125,8,6,3,4,7,3,4,"High",2,2
"4875",28,172,1,0.7995,121,26,6,1,4,2,6,4,4,"High",5,5
"4876",28,173,0,1.1076,124,50,6,9,4,3,7,3,4,"High",-3,3
"4877",28,174,1,1.12,119,58,3,4,2,3,5,2,4,"High",-1,1
"4878",28,175,1,0.86215,84,58,9,4,3,4,7,3,4,"High",5,5
"4879",28,176,0,1.8565,38,34,8,9,4,3,7,3,4,"High",-1,1
"4880",28,177,0,1.2502,69,94,2,2,2,3,5,3,4,"High",0,0
"4881",28,178,0,2.1792,119,65,3,8,3,3,6,3,4,"High",-5,5
"4882",28,179,0,1.0264,26,114,1,2,3,2,5,2,4,"High",-1,1
"4883",28,180,1,1.5307,73,34,8,9,4,4,8,4,4,"High",-1,1
"4884",28,181,0,1.478,21,83,5,9,4,3,7,3,4,"High",-4,4
"4885",28,182,0,1.0154,69,94,2,2,3,4,7,4,4,"High",0,0
"4886",28,183,1,1.3735,65,45,8,9,4,4,8,4,4,"High",-1,1
"4887",28,184,0,1.7408,102,117,2,3,2,4,6,4,4,"High",-1,1
"4888",28,185,0,0.72685,29,87,9,10,3,4,7,4,4,"High",-1,1
"4889",28,186,0,1.6996,119,66,3,7,4,3,7,3,4,"High",-4,4
"4890",28,187,1,0.69422,66,69,7,2,4,4,8,4,4,"High",5,5
"4891",28,188,1,2.0496,84,83,9,9,4,4,8,4,4,"High",0,0
"4892",28,189,1,0.86642,114,26,2,1,3,4,7,3,4,"High",1,1
"4893",28,190,0,1.0282,29,35,9,10,4,1,5,1,4,"High",-1,1
"4894",28,191,0,1.1076,35,41,10,10,2,4,6,4,4,"High",0,0
"4895",28,192,0,0.7018,43,114,2,2,3,4,7,4,4,"High",0,0
"4896",28,193,0,0.8805,50,35,9,10,4,3,7,3,4,"High",-1,1
"4897",28,194,0,1.3785,43,102,2,2,4,3,7,3,4,"High",0,0
"4898",29,1,1,1.1186,82,33,4,5,0,0,0,0,4,"Low",-1,1
"4899",29,2,1,1.0539,139,17,7,2,0,0,0,0,4,"Low",5,5
"4900",29,3,0,1.0987,33,117,5,9,1,0,1,0,4,"Low",-4,4
"4901",29,4,1,1.6601,134,139,8,7,0,1,1,0,4,"Low",1,1
"4902",29,5,1,2.4883,101,121,8,7,0,0,0,0,4,"Low",1,1
"4903",29,6,0,1.9366,18,58,8,9,0,0,0,0,4,"Low",-1,1
"4904",29,7,0,1.1462,85,139,7,7,0,2,2,2,4,"Low",0,0
"4905",29,8,1,1.1824,104,54,6,1,0,0,0,0,4,"Low",5,5
"4906",29,9,0,1.7011,91,105,2,5,0,0,0,0,4,"Low",-3,3
"4907",29,10,0,1.9066,78,34,6,2,0,0,0,0,4,"Low",4,4
"4908",29,11,1,1.203,84,103,9,5,0,0,0,0,4,"Low",4,4
"4909",29,12,0,1.5664,32,35,5,7,0,0,0,0,4,"Low",-2,2
"4910",29,13,1,1.9819,33,37,5,1,2,0,2,2,4,"Low",4,4
"4911",29,14,1,1.7634,139,94,7,5,3,0,3,3,4,"Low",2,2
"4912",29,15,0,1.107,90,35,4,7,0,1,1,1,4,"Low",-3,3
"4913",29,16,0,2.2032,117,104,9,6,1,1,2,1,4,"Low",3,3
"4914",29,17,1,2.2092,55,120,5,1,0,0,0,0,4,"Low",4,4
"4915",29,18,0,0.86455,103,105,5,5,1,1,2,1,4,"Low",0,0
"4916",29,19,1,1.3004,8,114,3,2,0,0,0,0,4,"Low",1,1
"4917",29,20,1,1.3191,101,121,8,7,1,1,2,1,4,"Low",1,1
"4918",29,21,1,2.0152,139,129,7,8,4,0,4,4,4,"Low",-1,1
"4919",29,22,1,0.88871,83,32,10,5,0,1,1,0,4,"Low",5,5
"4920",29,23,0,2.002,23,90,5,4,0,1,1,1,4,"Low",1,1
"4921",29,24,1,2.6612,117,71,9,7,2,0,2,2,4,"Low",2,2
"4922",29,25,0,2.7359,6,54,1,1,0,1,1,1,4,"Low",0,0
"4923",29,26,0,1.3967,55,63,5,6,1,0,1,0,4,"Low",-1,1
"4924",29,27,0,1.1074,55,34,5,2,2,1,3,1,4,"Low",3,3
"4925",29,28,1,2.4604,33,94,5,5,3,1,4,3,4,"Low",0,0
"4926",29,29,1,1.1703,83,134,10,8,1,1,2,1,4,"Low",2,2
"4927",29,30,0,2.7577,82,134,4,8,1,2,3,2,4,"Low",-4,4
"4928",29,31,0,1.2861,20,41,3,8,0,0,0,0,4,"Low",-5,5
"4929",29,32,1,1.4164,103,121,5,7,2,2,4,2,4,"Low",-2,2
"4930",29,33,0,1.2193,78,114,6,2,1,1,2,1,4,"Low",4,4
"4931",29,34,0,1.2122,31,101,7,8,0,2,2,2,4,"Low",-1,1
"4932",29,35,1,0.9213,121,137,7,7,3,0,3,3,4,"Low",0,0
"4933",29,36,1,1.7869,114,146,2,1,2,0,2,2,4,"Low",1,1
"4934",29,37,0,1.396,74,116,7,7,0,0,0,0,4,"Low",0,0
"4935",29,38,0,1.9386,144,117,6,9,0,3,3,3,4,"Low",-3,3
"4936",29,39,1,1.3332,41,68,8,7,1,0,1,1,4,"Low",1,1
"4937",29,40,1,1.0309,41,20,8,3,2,1,3,2,4,"Low",5,5
"4938",29,41,0,1.3326,78,87,6,1,2,0,2,0,4,"Low",5,5
"4939",29,42,0,1.288,91,34,2,2,1,2,3,2,4,"Low",0,0
"4940",29,43,1,0.73957,101,63,8,6,3,1,4,3,4,"Low",2,2
"4941",29,44,1,0.88803,70,78,2,6,0,3,3,0,4,"Low",-4,4
"4942",29,45,0,1.3888,82,34,4,2,2,3,5,3,4,"High",2,2
"4943",29,46,1,0.84822,33,17,5,2,4,1,5,4,4,"High",3,3
"4944",29,47,1,1.3467,34,114,2,2,4,3,7,4,4,"High",0,0
"4945",29,48,1,0.90544,58,94,9,5,1,2,3,1,4,"Low",4,4
"4946",29,49,1,1.3561,118,32,10,5,0,2,2,0,4,"Low",5,5
"4947",29,50,0,2.4294,73,144,7,6,0,1,1,1,4,"Low",1,1
"4948",29,51,1,1.1539,82,71,4,7,3,1,4,3,4,"Low",-3,3
"4949",29,52,1,0.84968,63,100,6,5,2,0,2,2,4,"Low",1,1
"4950",29,53,0,1.8377,146,23,1,5,1,1,2,1,4,"Low",-4,4
"4951",29,54,0,1.3257,20,100,3,5,2,1,3,1,4,"Low",-2,2
"4952",29,55,0,2.1405,120,105,1,5,1,2,3,2,4,"Low",-4,4
"4953",29,56,1,1.0052,124,100,7,5,0,2,2,0,4,"Low",2,2
"4954",29,57,0,1.3778,6,82,1,4,1,4,5,4,4,"High",-3,3
"4955",29,58,1,1.2706,43,54,2,1,0,2,2,0,4,"Low",1,1
"4956",29,59,0,1.3137,73,119,7,10,1,0,1,0,4,"Low",-3,3
"4957",29,60,0,1.84,6,146,1,1,2,2,4,2,4,"Low",0,0
"4958",29,61,0,1.1411,32,58,5,9,3,2,5,2,4,"High",-4,4
"4959",29,62,0,1.3726,120,114,1,2,2,4,6,4,4,"High",-1,1
"4960",29,63,0,0.98034,20,102,3,1,3,0,3,0,4,"Low",2,2
"4961",29,64,0,1.4561,73,144,7,6,2,2,4,2,4,"Low",1,1
"4962",29,65,0,0.92853,120,55,1,5,3,3,6,3,4,"High",-4,4
"4963",29,66,0,0.88137,78,35,6,7,4,2,6,2,4,"High",-1,1
"4964",29,67,1,0.78691,146,47,1,3,3,0,3,3,4,"Low",-2,2
"4965",29,68,0,1.1374,20,32,3,5,4,4,8,4,4,"High",-2,2
"4966",29,69,1,0.89831,63,68,6,7,3,1,4,3,4,"Low",-1,1
"4967",29,70,0,1.7883,18,27,8,9,1,0,1,0,4,"Low",-1,1
"4968",29,71,1,0.73203,83,71,10,7,2,2,4,2,4,"Low",3,3
"4969",29,72,1,1.0929,41,63,8,6,3,4,7,3,4,"High",2,2
"4970",29,73,1,0.67624,58,105,9,5,3,3,6,3,4,"High",4,4
"4971",29,74,0,0.7928,90,129,4,8,2,1,3,1,4,"Low",-4,4
"4972",29,75,0,0.63773,120,93,1,3,4,0,4,0,4,"Low",-2,2
"4973",29,76,0,0.81863,105,119,5,10,4,1,5,1,4,"High",-5,5
"4974",29,77,1,0.84797,124,103,7,5,1,3,4,1,4,"Low",2,2
"4975",29,78,1,1.1863,100,102,5,1,3,1,4,3,4,"Low",4,4
"4976",29,79,1,1.1734,119,35,10,7,2,3,5,2,4,"High",3,3
"4977",29,80,1,2.0404,93,43,3,2,1,1,2,1,4,"Low",1,1
"4978",29,81,0,0.75643,91,116,2,7,2,1,3,1,4,"Low",-5,5
"4979",29,82,1,0.93304,144,55,6,5,3,4,7,3,4,"High",1,1
"4980",29,83,0,1.7624,6,103,1,5,3,4,7,4,4,"High",-4,4
"4981",29,84,1,0.84766,100,83,5,10,4,3,7,4,4,"High",-5,5
"4982",29,85,1,1.7381,121,47,7,3,4,1,5,4,4,"High",4,4
"4983",29,86,1,1.1728,87,17,1,2,1,2,3,1,4,"Low",-1,1
"4984",29,87,0,1.3063,85,118,7,10,1,1,2,1,4,"Low",-3,3
"4985",29,88,1,1.2784,93,17,3,2,2,3,5,2,4,"High",1,1
"4986",29,89,1,2.6998,50,37,4,1,0,1,1,0,4,"Low",3,3
"4987",29,90,0,0.97303,6,17,1,2,4,4,8,4,4,"High",-1,1
"4988",29,91,0,2.1885,31,93,7,3,1,3,4,3,4,"Low",4,4
"4989",29,92,0,1.5763,65,8,1,3,0,1,1,1,4,"Low",-2,2
"4990",29,93,0,1.0699,50,8,4,3,1,2,3,2,4,"Low",1,1
"4991",29,94,0,2.2657,146,90,1,4,4,3,7,3,4,"High",-3,3
"4992",29,95,0,1.5158,85,144,7,6,2,4,6,4,4,"High",1,1
"4993",29,96,0,1.3437,50,68,4,7,2,2,4,2,4,"Low",-3,3
"4994",29,97,1,1.3426,18,129,8,8,2,2,4,2,4,"Low",0,0
"4995",29,98,0,1.0619,31,68,7,7,2,3,5,3,4,"High",0,0
"4996",29,99,0,0.90584,69,50,4,4,0,3,3,3,4,"Low",0,0
"4997",29,100,0,2.9234,54,104,1,6,3,2,5,2,4,"High",-5,5
"4998",29,101,1,0.82964,8,70,3,2,3,1,4,3,4,"Low",1,1
"4999",29,102,1,0.87079,85,69,7,4,3,1,4,3,4,"Low",3,3
"5000",29,103,0,0.85349,47,124,3,7,2,2,4,2,4,"Low",-4,4
"5001",29,104,1,2.8055,119,18,10,8,3,3,6,3,4,"High",2,2
"5002",29,105,1,2.5721,27,71,9,7,1,3,4,1,4,"Low",2,2
"5003",29,106,0,1.0821,71,124,7,7,4,3,7,3,4,"High",0,0
"5004",29,107,1,1.8596,94,68,5,7,3,4,7,3,4,"High",-2,2
"5005",29,108,1,1.219,118,101,10,8,2,4,6,2,4,"High",2,2
"5006",29,109,1,0.75381,83,129,10,8,4,3,7,4,4,"High",2,2
"5007",29,110,1,1.961,84,74,9,7,1,1,2,1,4,"Low",2,2
"5008",29,111,1,0.67767,85,124,7,7,4,4,8,4,4,"High",0,0
"5009",29,112,0,1.0571,69,134,4,8,2,3,5,3,4,"High",-4,4
"5010",29,113,0,1.3778,122,134,4,8,0,4,4,4,4,"Low",-4,4
"5011",29,114,1,0.81799,58,69,9,4,4,3,7,4,4,"High",5,5
"5012",29,115,0,0.7844,73,27,7,9,3,2,5,2,4,"High",-2,2
"5013",29,116,0,0.76737,41,118,8,10,4,3,7,3,4,"High",-2,2
"5014",29,117,1,1.3821,27,90,9,4,3,4,7,3,4,"High",5,5
"5015",29,118,0,0.96537,35,119,7,10,4,4,8,4,4,"High",-3,3
"5016",29,119,0,0.76498,50,116,4,7,4,2,6,2,4,"High",-3,3
"5017",29,120,1,0.60884,116,118,7,10,3,4,7,3,4,"High",-3,3
"5018",29,121,0,1.3793,94,8,5,3,4,4,8,4,4,"High",2,2
"5019",29,122,0,0.69832,31,116,7,7,3,4,7,4,4,"High",0,0
"5020",29,123,1,0.88387,102,93,1,3,2,4,6,2,4,"High",-2,2
"5021",29,124,1,0.74981,69,65,4,1,4,1,5,4,4,"High",3,3
"5022",29,125,0,0.67011,129,27,8,9,4,4,8,4,4,"High",-1,1
"5023",29,126,1,2.2091,73,47,7,3,4,3,7,4,4,"High",4,4
"5024",29,127,0,1.1132,23,87,5,1,2,2,4,2,4,"Low",4,4
"5025",29,128,0,0.79451,43,137,2,7,2,1,3,1,4,"Low",-5,5
"5026",29,129,0,1.0625,122,47,4,3,1,4,5,4,4,"High",1,1
"5027",29,130,0,1.0646,74,104,7,6,2,3,5,3,4,"High",1,1
"5028",29,131,0,0.95814,23,117,5,9,3,4,7,4,4,"High",-4,4
"5029",29,132,1,0.56016,104,65,6,1,4,2,6,4,4,"High",5,5
"5030",29,133,0,0.76047,23,43,5,2,4,3,7,3,4,"High",3,3
"5031",29,134,1,1.5983,87,91,1,2,3,3,6,3,4,"High",-1,1
"5032",29,135,0,1.2963,54,87,1,1,4,4,8,4,4,"High",0,0
"5033",29,136,1,2.0448,102,43,1,2,3,4,7,3,4,"High",-1,1
"5034",29,137,0,0.96589,137,74,7,7,2,3,5,3,4,"High",0,0
"5035",29,138,1,0.90339,137,70,7,2,3,2,5,3,4,"High",5,5
"5036",29,139,1,0.96312,84,31,9,7,2,4,6,2,4,"High",2,2
"5037",29,140,1,0.72818,18,137,8,7,4,4,8,4,4,"High",1,1
"5038",29,141,0,0.94423,122,84,4,9,2,3,5,3,4,"High",-5,5
"5039",29,142,0,1.7111,37,91,1,2,2,4,6,4,4,"High",-1,1
"5040",29,143,0,1.3155,70,102,2,1,3,4,7,4,4,"High",1,1
"5041",29,144,0,1.7478,74,84,7,9,4,4,8,4,4,"High",-2,2
"5042",29,145,1,1.1891,65,122,1,4,3,3,6,3,4,"High",-3,3
"5043",29,146,1,1.5007,65,37,1,1,4,3,7,4,4,"High",0,0
"5044",29,147,0,1.2446,122,70,4,2,4,4,8,4,4,"High",2,2
"5045",30,1,0,1.3661,55,50,2,7,0,0,0,0,3,"Low",-5,5
"5046",30,2,1,1.1931,77,101,8,6,0,0,0,0,3,"Low",2,2
"5047",30,3,0,2.7474,141,31,8,10,0,0,0,0,3,"Low",-2,2
"5048",30,4,1,1.0614,79,123,9,4,0,0,0,0,3,"Low",5,5
"5049",30,5,0,1.3394,43,31,6,10,0,1,1,1,3,"Low",-4,4
"5050",30,6,1,0.90016,102,40,4,4,0,0,0,0,3,"Low",0,0
"5051",30,7,0,2.7502,1,90,5,3,0,0,0,0,3,"Low",2,2
"5052",30,8,0,1.1333,23,55,1,2,0,1,1,1,3,"Low",-1,1
"5053",30,9,0,1.4978,115,66,4,8,0,0,0,0,3,"Low",-4,4
"5054",30,10,1,3.2324,53,133,9,8,0,0,0,0,3,"Low",1,1
"5055",30,11,0,1.1942,84,137,7,8,0,0,0,0,3,"Low",-1,1
"5056",30,12,0,1.2651,129,147,6,8,0,0,0,0,3,"Low",-2,2
"5057",30,13,0,1.0686,10,89,2,5,0,0,0,0,3,"Low",-3,3
"5058",30,14,0,1.4539,108,20,2,7,0,0,0,0,3,"Low",-5,5
"5059",30,15,0,1.0513,9,98,3,8,0,0,0,0,3,"Low",-5,5
"5060",30,16,0,1.5353,15,115,3,4,0,1,1,1,3,"Low",-1,1
"5061",30,17,0,1.1722,130,9,5,3,0,1,1,1,3,"Low",2,2
"5062",30,18,0,1.5234,88,21,2,7,0,0,0,0,3,"Low",-5,5
"5063",30,19,0,2.6674,94,96,6,6,0,0,0,0,3,"Low",0,0
"5064",30,20,0,1.7082,41,73,8,8,0,0,0,0,3,"Low",0,0
"5065",30,21,1,2.0541,51,106,7,3,0,0,0,0,3,"Low",4,4
"5066",30,22,1,1.1945,46,43,10,6,0,1,1,0,3,"Low",4,4
"5067",30,23,1,0.9867,87,40,7,4,0,1,1,0,3,"Low",3,3
"5068",30,24,1,1.2603,137,43,8,6,1,2,3,1,3,"Low",2,2
"5069",30,25,0,3.9765,80,144,4,2,0,0,0,0,3,"Low",2,2
"5070",30,26,1,2.6612,37,11,3,2,0,0,0,0,3,"Low",1,1
"5071",30,27,0,2.5765,38,67,3,4,0,0,0,0,3,"Low",-1,1
"5072",30,28,1,1.4,140,1,7,5,0,1,1,0,3,"Low",2,2
"5073",30,29,0,2.2542,91,3,4,9,0,0,0,0,3,"Low",-5,5
"5074",30,30,0,2.3861,100,121,8,7,0,0,0,0,3,"Low",1,1
"5075",30,31,1,3.5526,134,19,5,3,0,0,0,0,3,"Low",2,2
"5076",30,32,0,1.281,59,57,4,4,0,0,0,0,3,"Low",0,0
"5077",30,33,1,1.4198,107,111,7,4,0,0,0,0,3,"Low",3,3
"5078",30,34,0,1.1036,34,133,9,8,0,1,1,1,3,"Low",1,1
"5079",30,35,0,3.0518,20,92,7,10,1,0,1,0,3,"Low",-3,3
"5080",30,36,1,1.4251,43,116,6,1,3,0,3,3,3,"Low",5,5
"5081",30,37,0,1.2238,90,16,3,7,1,0,1,0,3,"Low",-4,4
"5082",30,38,0,0.85152,24,110,4,8,0,0,0,0,3,"Low",-4,4
"5083",30,39,0,1.8234,57,124,4,8,1,0,1,0,3,"Low",-4,4
"5084",30,40,0,1.1726,33,30,3,8,0,0,0,0,3,"Low",-5,5
"5085",30,41,1,1.356,34,40,9,4,1,2,3,1,3,"Low",5,5
"5086",30,42,1,2.347,125,107,9,7,0,1,1,0,3,"Low",2,2
"5087",30,43,1,1.451,95,118,8,5,0,0,0,0,3,"Low",3,3
"5088",30,44,1,1.199,31,51,10,7,2,1,3,2,3,"Low",3,3
"5089",30,45,1,1.0371,67,130,4,5,1,1,2,1,3,"Low",-1,1
"5090",30,46,0,2.5298,145,143,7,8,0,0,0,0,3,"Low",-1,1
"5091",30,47,1,1.0823,6,101,9,6,0,1,1,0,3,"Low",3,3
"5092",30,48,1,1.0157,50,43,7,6,1,4,5,1,3,"High",1,1
"5093",30,49,1,1.6451,25,24,5,4,0,1,1,0,3,"Low",1,1
"5094",30,50,0,2.1539,93,49,6,9,0,0,0,0,3,"Low",-3,3
"5095",30,51,0,0.89669,111,79,4,9,1,1,2,1,3,"Low",-5,5
"5096",30,52,0,1.4027,42,73,7,8,0,1,1,1,3,"Low",-1,1
"5097",30,53,0,1.3768,104,85,5,7,0,0,0,0,3,"Low",-2,2
"5098",30,54,0,1.1444,40,2,4,6,3,0,3,0,3,"Low",-2,2
"5099",30,55,0,1.2247,11,81,2,3,1,0,1,0,3,"Low",-1,1
"5100",30,56,0,4.3585,85,133,7,8,1,2,3,2,3,"Low",-1,1
"5101",30,57,1,1.1744,110,65,8,9,1,0,1,1,3,"Low",-1,1
"5102",30,58,1,1.0138,132,99,10,9,0,0,0,0,3,"Low",1,1
"5103",30,59,1,1.7032,61,102,7,4,0,1,1,0,3,"Low",3,3
"5104",30,60,1,1.505,55,37,2,3,2,1,3,2,3,"Low",-1,1
"5105",30,61,1,2.6113,62,126,7,8,0,0,0,0,3,"Low",-1,1
"5106",30,62,0,1.5133,63,3,4,9,0,1,1,1,3,"Low",-5,5
"5107",30,63,1,2.7074,20,38,7,3,2,1,3,2,3,"Low",4,4
"5108",30,64,0,1.9182,126,99,8,9,1,1,2,1,3,"Low",-1,1
"5109",30,65,1,2.2074,97,136,9,8,0,0,0,0,3,"Low",1,1
"5110",30,66,1,0.96552,110,58,8,5,2,0,2,2,3,"Low",3,3
"5111",30,67,0,1.1649,24,80,4,4,2,1,3,1,3,"Low",0,0
"5112",30,68,0,4.2522,27,111,7,4,0,2,2,2,3,"Low",3,3
"5113",30,69,1,1.1204,49,121,9,7,1,1,2,1,3,"Low",2,2
"5114",30,70,1,1.2498,84,1,7,5,1,2,3,1,3,"Low",2,2
"5115",30,71,1,1.2937,114,77,9,8,0,1,1,0,3,"Low",1,1
"5116",30,72,1,1.2244,60,102,9,4,0,2,2,0,3,"Low",5,5
"5117",30,73,1,1.2698,73,2,8,6,2,1,3,2,3,"Low",2,2
"5118",30,74,1,1.8185,112,10,5,2,0,1,1,0,3,"Low",3,3
"5119",30,75,1,1.2159,21,44,7,6,1,0,1,1,3,"Low",1,1
"5120",30,76,0,1.4213,76,85,2,7,0,2,2,2,3,"Low",-5,5
"5121",30,77,1,0.96249,62,59,7,4,1,1,2,1,3,"Low",3,3
"5122",30,78,0,1.9954,76,47,2,6,1,0,1,0,3,"Low",-4,4
"5123",30,79,0,1.3212,25,73,5,8,1,3,4,3,3,"High",-3,3
"5124",30,80,0,1.4749,104,115,5,4,1,2,3,2,3,"Low",1,1
"5125",30,81,0,5.606,32,87,6,7,0,1,1,1,3,"Low",-1,1
"5126",30,82,1,1.0289,65,71,9,10,1,0,1,1,3,"Low",-1,1
"5127",30,83,0,1.8824,112,45,5,10,1,0,1,0,3,"Low",-5,5
"5128",30,84,1,1.4751,67,61,4,7,2,1,3,2,3,"Low",-3,3
"5129",30,85,1,4.0708,68,147,10,8,0,1,1,0,3,"Low",2,2
"5130",30,86,1,1.0694,137,50,8,7,2,2,4,2,3,"High",1,1
"5131",30,87,1,1.4049,100,59,8,4,1,2,3,1,3,"Low",4,4
"5132",30,88,1,1.6658,113,85,10,7,0,3,3,0,3,"Low",3,3
"5133",30,89,0,1.6599,136,66,8,8,1,1,2,1,3,"Low",0,0
"5134",30,90,0,1.4731,51,20,7,7,2,3,5,3,3,"High",0,0
"5135",30,91,0,1.1893,32,6,6,9,1,1,2,1,3,"Low",-3,3
"5136",30,92,0,6.0328,61,49,7,9,2,2,4,2,3,"High",-2,2
"5137",30,93,1,1.1805,85,108,7,2,4,1,5,4,3,"High",5,5
"5138",30,94,0,1.3242,27,44,7,6,1,1,2,1,3,"Low",1,1
"5139",30,95,1,1.1042,90,10,3,2,2,2,4,2,3,"High",1,1
"5140",30,96,1,2.2801,128,61,7,7,0,3,3,0,3,"Low",0,0
"5141",30,97,0,1.0344,51,77,7,8,3,2,5,2,3,"High",-1,1
"5142",30,98,0,2.9771,41,98,8,8,1,1,2,1,3,"Low",0,0
"5143",30,99,0,1.0365,10,67,2,4,3,3,6,3,3,"High",-2,2
"5144",30,100,0,2.6251,65,66,9,8,2,2,4,2,3,"High",1,1
"5145",30,101,1,1.9504,78,98,10,8,0,2,2,0,3,"Low",2,2
"5146",30,102,0,1.0704,117,140,2,7,0,1,1,1,3,"Low",-5,5
"5147",30,103,0,1.2019,51,79,7,9,4,2,6,2,3,"High",-2,2
"5148",30,104,0,1.2266,126,132,8,10,2,1,3,1,3,"Low",-2,2
"5149",30,105,0,1.192,106,41,3,8,1,2,3,2,3,"Low",-5,5
"5150",30,106,0,6.8546,128,36,7,6,1,0,1,0,3,"Low",1,1
"5151",30,107,0,1.3532,33,56,3,5,1,0,1,0,3,"Low",-2,2
"5152",30,108,0,1.37,145,77,7,8,1,3,4,3,3,"High",-1,1
"5153",30,109,1,1.9834,90,12,3,2,3,0,3,3,3,"Low",1,1
"5154",30,110,1,1.6301,46,93,10,6,1,1,2,1,3,"Low",4,4
"5155",30,111,0,3.691,134,44,5,6,1,2,3,2,3,"Low",-1,1
"5156",30,112,1,1.4295,113,42,10,7,1,1,2,1,3,"Low",3,3
"5157",30,113,1,1.2243,77,18,8,9,4,0,4,4,3,"High",-1,1
"5158",30,114,1,1.8637,13,117,1,2,0,1,1,0,3,"Low",-1,1
"5159",30,115,0,5.259,54,57,1,4,0,2,2,2,3,"Low",-3,3
"5160",30,116,1,2.4389,142,25,5,5,0,2,2,0,3,"Low",0,0
"5161",30,117,1,3.1558,45,48,10,7,1,0,1,1,3,"Low",3,3
"5162",30,118,1,1.0758,133,67,8,4,3,4,7,3,3,"High",4,4
"5163",30,119,0,1.1541,100,20,8,7,2,4,6,4,3,"High",1,1
"5164",30,120,0,0.93558,27,132,7,10,2,2,4,2,3,"High",-3,3
"5165",30,121,1,2.1759,9,112,3,5,2,2,4,2,3,"High",-2,2
"5166",30,122,1,1.7833,1,76,5,2,3,2,5,3,3,"High",3,3
"5167",30,123,1,2.8941,3,123,9,4,2,1,3,2,3,"Low",5,5
"5168",30,124,0,4.3914,52,105,4,5,0,0,0,0,3,"Low",-1,1
"5169",30,125,0,5.0668,41,95,8,8,3,1,4,1,3,"High",0,0
"5170",30,126,0,3.5343,19,121,3,7,1,2,3,2,3,"Low",-4,4
"5171",30,127,1,1.1291,4,24,9,4,0,3,3,0,3,"Low",5,5
"5172",30,128,1,1.8445,57,1,4,5,3,4,7,3,3,"High",-1,1
"5173",30,129,1,1.5292,62,129,7,6,2,1,3,2,3,"Low",1,1
"5174",30,130,1,2.2658,120,32,4,6,0,2,2,0,3,"Low",-2,2
"5175",30,131,1,1.3092,144,117,2,2,1,2,3,1,3,"Low",0,0
"5176",30,132,1,2.4939,48,10,7,2,1,4,5,1,3,"High",5,5
"5177",30,133,1,2.6019,143,128,8,7,1,2,3,1,3,"Low",1,1
"5178",30,134,0,2.9399,136,71,8,10,2,1,3,1,3,"Low",-2,2
"5179",30,135,0,6.0846,16,71,7,10,1,2,3,2,3,"Low",-3,3
"5180",30,136,0,1.6086,40,140,4,7,4,2,6,2,3,"High",-3,3
"5181",30,137,1,1.0147,62,59,7,4,3,3,6,3,3,"High",3,3
"5182",30,138,1,0.90844,97,52,9,4,1,1,2,1,3,"Low",5,5
"5183",30,139,1,1.9424,26,66,9,8,0,3,3,0,3,"Low",1,1
"5184",30,140,1,1.1082,140,6,7,9,3,2,5,3,3,"High",-2,2
"5185",30,141,0,2.0064,49,78,9,10,3,1,4,1,3,"High",-1,1
"5186",30,142,0,1.7962,29,143,10,8,0,2,2,2,3,"Low",2,2
"5187",30,143,1,2.4581,120,80,4,4,1,2,3,1,3,"Low",0,0
"5188",30,144,0,1.5752,38,141,3,8,2,1,3,1,3,"Low",-5,5
"5189",30,145,0,1.4303,32,61,6,7,3,4,7,4,3,"High",-1,1
"5190",30,146,1,1.8411,110,134,8,5,3,2,5,3,3,"High",3,3
"5191",30,147,1,1.254,140,58,7,5,4,1,5,4,3,"High",2,2
"5192",30,148,0,1.0393,41,147,8,8,4,2,6,2,3,"High",0,0
"5193",30,149,0,2.0788,23,74,1,4,1,0,1,0,3,"Low",-3,3
"5194",30,150,0,2.0088,118,145,5,7,1,2,3,2,3,"Low",-2,2
"5195",30,151,0,1.0742,63,131,4,8,1,0,1,0,3,"Low",-4,4
"5196",30,152,1,1.4927,81,96,3,6,1,1,2,1,3,"Low",-3,3
"5197",30,153,0,0.9193,96,62,6,7,2,4,6,4,3,"High",-1,1
"5198",30,154,0,0.71649,104,132,5,10,2,3,5,3,3,"High",-5,5
"5199",30,155,0,1.1058,34,16,9,7,2,2,4,2,3,"High",2,2
"5200",30,156,0,4.0516,113,31,10,10,2,3,5,3,3,"High",0,0
"5201",30,157,1,1.5838,93,32,6,6,2,4,6,2,3,"High",0,0
"5202",30,158,0,1.2945,9,89,3,5,3,1,4,1,3,"High",-2,2
"5203",30,159,0,1.1451,42,36,7,6,2,1,3,1,3,"Low",1,1
"5204",30,160,1,1.4822,101,60,6,9,2,1,3,2,3,"Low",-3,3
"5205",30,161,0,1.3565,33,2,3,6,2,2,4,2,3,"High",-3,3
"5206",30,162,0,1.3455,93,46,6,10,3,2,5,2,3,"High",-4,4
"5207",30,163,0,1.074,36,48,6,7,2,2,4,2,3,"High",-1,1
"5208",30,164,1,1.2529,114,96,9,6,1,3,4,1,3,"High",3,3
"5209",30,165,0,1.0449,131,31,8,10,1,4,5,4,3,"High",-2,2
"5210",30,166,1,1.6704,113,129,10,6,3,2,5,3,3,"High",4,4
"5211",30,167,0,1.7938,84,110,7,8,2,4,6,4,3,"High",-1,1
"5212",30,168,1,1.7729,69,125,10,9,0,1,1,0,3,"Low",1,1
"5213",30,169,0,1.6172,98,123,8,4,3,2,5,2,3,"High",4,4
"5214",30,170,0,0.99573,44,45,6,10,3,2,5,2,3,"High",-4,4
"5215",30,171,1,1.3312,139,38,8,3,0,3,3,0,3,"Low",5,5
"5216",30,172,1,1.644,38,115,3,4,4,3,7,4,3,"High",-1,1
"5217",30,173,0,1.017,58,26,5,9,2,1,3,1,3,"Low",-4,4
"5218",30,174,0,1.2819,72,9,2,3,0,4,4,4,3,"High",-1,1
"5219",30,175,0,2.5726,24,117,4,2,4,3,7,3,3,"High",2,2
"5220",30,176,0,1.0272,58,65,5,9,3,3,6,3,3,"High",-4,4
"5221",30,177,1,1.2881,101,58,6,5,3,4,7,3,3,"High",1,1
"5222",30,178,0,2.4188,30,92,8,10,1,1,2,1,3,"Low",-2,2
"5223",30,179,0,2.3439,15,118,3,5,1,2,3,2,3,"Low",-2,2
"5224",30,180,1,2.2863,134,106,5,3,3,2,5,3,3,"High",2,2
"5225",30,181,1,1.6941,72,91,2,4,1,1,2,1,3,"Low",-2,2
"5226",30,182,0,1.5063,137,113,8,10,3,4,7,4,3,"High",-2,2
"5227",30,183,0,2.2121,116,94,1,6,1,1,2,1,3,"Low",-5,5
"5228",30,184,0,1.4504,42,74,7,4,3,1,4,1,3,"High",3,3
"5229",30,185,0,1.0384,63,112,4,5,2,3,5,3,3,"High",-1,1
"5230",30,186,1,1.7898,84,14,7,9,3,0,3,3,3,"Low",-2,2
"5231",30,187,1,5.8923,118,115,5,4,3,4,7,3,3,"High",1,1
"5232",30,188,1,3.1265,57,88,4,2,4,1,5,4,3,"High",2,2
"5233",30,189,1,1.1358,125,52,9,4,2,2,4,2,3,"High",5,5
"5234",30,190,0,1.3288,118,48,5,7,4,3,7,3,3,"High",-2,2
"5235",30,191,0,3.034,108,13,2,1,2,1,3,1,3,"Low",1,1
"5236",30,192,1,2.0148,47,54,6,1,1,1,2,1,3,"Low",5,5
"5237",30,193,1,1.18,127,88,7,2,0,2,2,0,3,"Low",5,5
"5238",30,194,0,1.0985,33,74,3,4,3,2,5,2,3,"High",-1,1
"5239",30,195,0,1.6608,108,119,2,3,3,0,3,0,3,"Low",-1,1
"5240",30,196,1,1.2729,3,105,9,5,3,1,4,3,3,"High",4,4
"5241",30,197,1,1.5241,7,70,9,10,0,0,0,0,3,"Low",-1,1
"5242",30,198,0,2.1974,2,48,6,7,3,4,7,4,3,"High",-1,1
"5243",30,199,1,1.9285,21,2,7,6,2,4,6,2,3,"High",1,1
"5244",30,200,0,2.1537,36,6,6,9,3,3,6,3,3,"High",-3,3
"5245",31,1,0,0.6401,21,66,9,9,0,0,0,0,4,"Low",0,0
"5246",31,2,0,0.66341,7,41,4,6,0,0,0,0,4,"Low",-2,2
"5247",31,3,1,1.0028,130,46,8,5,0,0,0,0,4,"Low",3,3
"5248",31,4,0,1.7596,38,67,6,8,0,0,0,0,4,"Low",-2,2
"5249",31,5,1,1.1818,10,141,4,2,0,0,0,0,4,"Low",2,2
"5250",31,6,0,1.6079,67,17,8,7,1,0,1,0,4,"Low",1,1
"5251",31,7,1,1.2687,8,126,3,3,0,0,0,0,4,"Low",0,0
"5252",31,8,1,1.4993,89,53,6,8,0,0,0,0,4,"Low",-2,2
"5253",31,9,1,0.67291,122,133,9,4,0,0,0,0,4,"Low",5,5
"5254",31,10,1,0.78101,123,17,10,7,0,1,1,0,4,"Low",3,3
"5255",31,11,1,0.75556,106,53,10,8,0,1,1,0,4,"Low",2,2
"5256",31,12,1,0.66238,129,12,10,8,0,0,0,0,4,"Low",2,2
"5257",31,13,0,0.98726,36,63,5,3,0,0,0,0,4,"Low",2,2
"5258",31,14,1,1.326,17,32,7,4,2,0,2,2,4,"Low",3,3
"5259",31,15,0,0.97725,73,3,5,5,0,0,0,0,4,"Low",0,0
"5260",31,16,1,1.5542,113,68,10,6,0,0,0,0,4,"Low",4,4
"5261",31,17,0,0.69681,101,113,10,10,0,1,1,1,4,"Low",0,0
"5262",31,18,1,0.68027,53,124,8,8,2,0,2,2,4,"Low",0,0
"5263",31,19,1,1.5488,68,63,6,3,1,1,2,1,4,"Low",3,3
"5264",31,20,0,0.92118,73,56,5,9,1,0,1,0,4,"Low",-4,4
"5265",31,21,1,1.8791,45,53,7,8,0,3,3,0,4,"Low",-1,1
"5266",31,22,1,0.82334,114,5,5,4,0,0,0,0,4,"Low",1,1
"5267",31,23,1,1.5013,121,54,7,10,0,0,0,0,4,"Low",-3,3
"5268",31,24,0,1.374,137,45,8,7,0,1,1,1,4,"Low",1,1
"5269",31,25,1,0.80665,38,126,6,3,1,1,2,1,4,"Low",3,3
"5270",31,26,1,0.98411,10,60,4,1,1,0,1,1,4,"Low",3,3
"5271",31,27,1,1.323,67,10,8,4,2,2,4,2,4,"Low",4,4
"5272",31,28,1,0.89247,143,10,6,4,0,3,3,0,4,"Low",2,2
"5273",31,29,0,1.1637,6,41,4,6,0,1,1,1,4,"Low",-2,2
"5274",31,30,0,0.98918,45,68,7,6,2,2,4,2,4,"Low",1,1
"5275",31,31,0,1.0726,6,112,4,7,1,0,1,0,4,"Low",-3,3
"5276",31,32,0,0.81447,36,12,5,8,1,1,2,1,4,"Low",-3,3
"5277",31,33,1,0.69067,58,7,3,4,0,1,1,0,4,"Low",-1,1
"5278",31,34,1,0.9139,120,35,7,2,0,0,0,0,4,"Low",5,5
"5279",31,35,1,1.4793,5,132,4,5,1,0,1,1,4,"Low",-1,1
"5280",31,36,1,1.2794,147,13,7,4,0,0,0,0,4,"Low",3,3
"5281",31,37,1,1.5208,13,92,4,1,1,0,1,1,4,"Low",3,3
"5282",31,38,1,0.75869,146,123,9,10,0,1,1,0,4,"Low",-1,1
"5283",31,39,0,1.3802,31,124,7,8,0,1,1,1,4,"Low",-1,1
"5284",31,40,0,1.1462,71,21,7,9,0,1,1,1,4,"Low",-2,2
"5285",31,41,1,0.82422,2,146,10,9,0,1,1,0,4,"Low",1,1
"5286",31,42,0,1.3331,112,106,7,10,1,1,2,1,4,"Low",-3,3
"5287",31,43,1,0.84907,4,121,3,7,0,1,1,0,4,"Low",-4,4
"5288",31,44,1,1.2751,5,116,4,6,2,0,2,2,4,"Low",-2,2
"5289",31,45,1,1.4974,82,112,3,7,0,2,2,0,4,"Low",-4,4
"5290",31,46,0,1.1447,147,101,7,10,1,1,2,1,4,"Low",-3,3
"5291",31,47,0,2.3025,6,69,4,8,2,0,2,0,4,"Low",-4,4
"5292",31,48,1,0.69578,124,71,8,7,2,1,3,2,4,"Low",1,1
"5293",31,49,0,1.7194,121,89,7,6,2,1,3,1,4,"Low",1,1
"5294",31,50,1,1.1181,65,36,10,5,0,2,2,0,4,"Low",5,5
"5295",31,51,1,1.2373,26,41,6,6,0,2,2,0,4,"Low",0,0
"5296",31,52,1,1.2155,101,45,10,7,2,3,5,2,4,"High",3,3
"5297",31,53,1,2.8323,115,42,3,5,0,0,0,0,4,"Low",-2,2
"5298",31,54,0,0.72708,69,62,8,10,1,0,1,0,4,"Low",-2,2
"5299",31,55,1,0.70704,115,42,3,5,1,1,2,1,4,"Low",-2,2
"5300",31,56,1,1.3943,89,7,6,4,2,2,4,2,4,"Low",2,2
"5301",31,57,1,0.83328,38,70,6,8,2,0,2,2,4,"Low",-2,2
"5302",31,58,1,1.3452,106,120,10,7,2,1,3,2,4,"Low",3,3
"5303",31,59,0,1.2714,143,67,6,8,1,3,4,3,4,"Low",-2,2
"5304",31,60,0,1.1469,36,137,5,8,3,1,4,1,4,"Low",-3,3
"5305",31,61,1,1.027,146,46,9,5,2,1,3,2,4,"Low",4,4
"5306",31,62,1,0.98573,38,126,6,3,3,2,5,3,4,"High",3,3
"5307",31,63,0,0.62296,53,122,8,9,4,1,5,1,4,"High",-1,1
"5308",31,64,0,1.3812,137,120,8,7,2,2,4,2,4,"Low",1,1
"5309",31,65,0,1.6426,101,130,10,8,3,1,4,1,4,"Low",2,2
"5310",31,66,1,1.1788,66,69,9,8,1,2,3,1,4,"Low",1,1
"5311",31,67,0,1.0886,60,8,1,3,1,1,2,1,4,"Low",-2,2
"5312",31,68,1,1.1369,115,4,3,3,2,1,3,2,4,"Low",0,0
"5313",31,69,1,0.79218,121,56,7,9,3,1,4,3,4,"Low",-2,2
"5314",31,70,1,0.81068,85,54,10,10,0,1,1,0,4,"Low",0,0
"5315",31,71,1,0.96359,110,28,5,2,0,0,0,0,4,"Low",3,3
"5316",31,72,1,0.81619,65,67,10,8,1,4,5,1,4,"High",2,2
"5317",31,73,0,1.5685,147,38,7,6,2,4,6,4,4,"High",1,1
"5318",31,74,0,0.92055,73,5,5,4,2,3,5,3,4,"High",1,1
"5319",31,75,1,1.3918,41,70,6,8,3,1,4,3,4,"Low",-2,2
"5320",31,76,0,0.96134,73,17,5,7,3,3,6,3,4,"High",-2,2
"5321",31,77,0,1.4099,2,85,10,10,1,1,2,1,4,"Low",0,0
"5322",31,78,1,1.0426,41,34,6,8,4,0,4,4,4,"Low",-2,2
"5323",31,79,0,1.1599,132,32,5,4,1,1,2,1,4,"Low",1,1
"5324",31,80,0,1.045,4,124,3,8,2,3,5,3,4,"High",-5,5
"5325",31,81,0,0.71642,7,110,4,5,3,1,4,1,4,"Low",-1,1
"5326",31,82,1,1.0017,45,137,7,8,4,3,7,4,4,"High",-1,1
"5327",31,83,0,1.5178,58,143,3,6,1,2,3,2,4,"Low",-3,3
"5328",31,84,1,2.394,68,10,6,4,3,4,7,3,4,"High",2,2
"5329",31,85,1,0.69481,114,69,5,8,1,3,4,1,4,"Low",-3,3
"5330",31,86,0,1.3894,42,146,5,9,2,3,5,3,4,"High",-4,4
"5331",31,87,0,1.8439,11,6,3,4,0,3,3,3,4,"Low",-1,1
"5332",31,88,0,0.80615,73,5,5,4,4,4,8,4,4,"High",1,1
"5333",31,89,1,1.0802,100,8,3,3,0,2,2,0,4,"Low",0,0
"5334",31,90,1,1.4988,44,132,2,5,0,2,2,0,4,"Low",-3,3
"5335",31,91,1,1.1449,115,36,3,5,3,4,7,3,4,"High",-2,2
"5336",31,92,0,0.76767,54,70,10,8,2,2,4,2,4,"Low",2,2
"5337",31,93,0,0.75319,71,100,7,3,2,1,3,1,4,"Low",4,4
"5338",31,94,0,0.82999,32,66,4,9,2,2,4,2,4,"Low",-5,5
"5339",31,95,0,1.4376,92,7,1,4,1,4,5,4,4,"High",-3,3
"5340",31,96,0,1.2119,44,147,2,7,1,3,4,3,4,"Low",-5,5
"5341",31,97,1,0.75584,50,137,10,8,0,4,4,0,4,"Low",2,2
"5342",31,98,1,1.0009,65,34,10,8,2,1,3,2,4,"Low",2,2
"5343",31,99,0,0.75598,49,143,3,6,0,3,3,3,4,"Low",-3,3
"5344",31,100,0,1.2523,46,66,5,9,2,3,5,3,4,"High",-4,4
"5345",31,101,1,0.91697,89,18,6,1,3,0,3,3,4,"Low",5,5
"5346",31,102,1,0.71684,2,143,10,6,2,4,6,2,4,"High",4,4
"5347",31,103,1,1.2952,122,120,9,7,2,3,5,2,4,"High",2,2
"5348",31,104,1,0.75112,100,31,3,7,2,1,3,2,4,"Low",-4,4
"5349",31,105,1,1.1336,94,58,6,3,0,2,2,0,4,"Low",3,3
"5350",31,106,0,1.2443,28,68,2,6,1,4,5,4,4,"High",-4,4
"5351",31,107,1,0.69121,110,141,5,2,2,1,3,2,4,"Low",3,3
"5352",31,108,1,1.3212,123,101,10,10,2,4,6,2,4,"High",0,0
"5353",31,109,0,1.0305,49,18,3,1,1,1,2,1,4,"Low",2,2
"5354",31,110,1,0.8342,115,92,3,1,4,2,6,4,4,"High",2,2
"5355",31,111,0,1.2116,54,56,10,9,3,2,5,2,4,"High",1,1
"5356",31,112,0,1.5774,6,13,4,4,4,2,6,2,4,"High",0,0
"5357",31,113,1,0.86744,26,70,6,8,1,3,4,1,4,"Low",-2,2
"5358",31,114,1,1.9202,124,114,8,5,4,2,6,4,4,"High",3,3
"5359",31,115,1,1.397,28,126,2,3,2,3,5,2,4,"High",-1,1
"5360",31,116,1,0.85698,106,31,10,7,3,2,5,3,4,"High",3,3
"5361",31,117,0,0.7143,13,26,4,6,3,2,5,2,4,"High",-2,2
"5362",31,118,0,1.3564,20,26,4,6,0,3,3,3,4,"Low",-2,2
"5363",31,119,1,0.77341,20,147,4,7,1,4,5,1,4,"High",-3,3
"5364",31,120,1,0.94876,46,60,5,1,3,2,5,3,4,"High",4,4
"5365",31,121,1,1.7901,34,56,8,9,2,3,5,2,4,"High",-1,1
"5366",31,122,1,2.2601,112,34,7,8,3,3,6,3,4,"High",-1,1
"5367",31,123,0,1.5667,120,129,7,10,4,1,5,1,4,"High",-3,3
"5368",31,124,1,1.0596,35,112,2,7,1,4,5,1,4,"High",-5,5
"5369",31,125,1,0.74349,85,42,10,5,2,3,5,2,4,"High",5,5
"5370",31,126,0,1.2062,35,58,2,3,2,3,5,3,4,"High",-1,1
"5371",31,127,1,2.4178,63,86,3,3,2,0,2,2,4,"Low",0,0
"5372",31,128,1,0.57446,85,17,10,7,3,4,7,3,4,"High",3,3
"5373",31,129,0,1.2489,2,50,10,10,3,1,4,1,4,"Low",0,0
"5374",31,130,0,0.87639,110,123,5,10,3,3,6,3,4,"High",-5,5
"5375",31,131,1,0.82486,85,46,10,5,4,4,8,4,4,"High",5,5
"5376",31,132,1,0.59533,122,132,9,5,3,3,6,3,4,"High",4,4
"5377",31,133,1,1.294,20,34,4,8,2,4,6,2,4,"High",-4,4
"5378",31,134,0,0.96807,146,123,9,10,4,4,8,4,4,"High",-1,1
"5379",31,135,0,0.87591,13,31,4,7,4,3,7,3,4,"High",-3,3
"5380",31,136,0,0.79425,141,11,2,3,2,1,3,1,4,"Low",-1,1
"5381",31,137,1,0.8337,129,42,10,5,2,4,6,2,4,"High",5,5
"5382",31,138,1,0.65838,21,3,9,5,2,1,3,2,4,"Low",4,4
"5383",31,139,1,0.63364,122,94,9,6,4,1,5,4,4,"High",3,3
"5384",31,140,0,1.2106,51,106,10,10,0,4,4,4,4,"Low",0,0
"5385",31,141,1,1.6163,44,86,2,3,2,1,3,2,4,"Low",-1,1
"5386",31,142,1,0.67036,133,63,4,3,1,3,4,1,4,"Low",1,1
"5387",31,143,1,1.2119,129,65,10,10,3,3,6,3,4,"High",0,0
"5388",31,144,1,0.79177,58,44,3,2,4,3,7,4,4,"High",1,1
"5389",31,145,1,0.85396,26,60,6,1,4,3,7,4,4,"High",5,5
"5390",31,146,0,0.89591,141,71,2,7,3,3,6,3,4,"High",-5,5
"5391",31,147,1,1.2468,63,70,3,8,4,4,8,4,4,"High",-5,5
"5392",31,148,1,0.84652,35,86,2,3,3,2,5,3,4,"High",-1,1
"5393",31,149,1,1.849,100,133,3,4,3,2,5,3,4,"High",-1,1
"5394",31,150,0,0.77777,132,50,5,10,4,2,6,2,4,"High",-5,5
"5395",31,151,0,0.73669,54,3,10,5,4,2,6,2,4,"High",5,5
"5396",31,152,0,0.70394,69,20,8,4,4,3,7,3,4,"High",4,4
"5397",31,153,0,0.85001,21,62,9,10,3,1,4,1,4,"Low",-1,1
"5398",31,154,0,0.61535,141,94,2,6,4,2,6,2,4,"High",-4,4
"5399",31,155,0,1.3388,56,114,9,5,4,3,7,3,4,"High",4,4
"5400",31,156,1,1.2928,32,18,4,1,3,2,5,3,4,"High",3,3
"5401",31,157,0,1.9403,121,20,7,4,4,4,8,4,4,"High",3,3
"5402",31,158,0,0.82914,44,11,2,3,4,2,6,2,4,"High",-1,1
"5403",31,159,0,1.3837,28,89,2,6,3,4,7,4,4,"High",-4,4
"5404",31,160,1,1.1317,35,116,2,6,4,1,5,4,4,"High",-4,4
"5405",31,161,1,1.1211,12,86,8,3,2,3,5,2,4,"High",5,5
"5406",31,162,0,1.0857,21,62,9,10,4,2,6,2,4,"High",-1,1
"5407",31,163,1,1.1773,130,133,8,4,2,3,5,2,4,"High",4,4
"5408",31,164,1,0.6985,32,28,4,2,4,4,8,4,4,"High",2,2
"5409",31,165,0,0.8847,86,133,3,4,4,4,8,4,4,"High",-1,1
"5410",31,166,1,1.1305,114,94,5,6,4,3,7,4,4,"High",-1,1
"5411",31,167,0,1.1774,8,18,3,1,3,3,6,3,4,"High",2,2
"5412",31,168,0,0.69349,126,12,3,8,4,3,7,3,4,"High",-5,5
"5413",31,169,1,0.62102,129,110,10,5,4,4,8,4,4,"High",5,5
"5414",31,170,1,1.5702,130,100,8,3,3,4,7,3,4,"High",5,5
"5415",31,171,1,0.74823,2,130,10,8,4,4,8,4,4,"High",2,2
"5416",31,172,1,0.98715,116,71,6,7,2,4,6,2,4,"High",-1,1
"5417",31,173,0,0.88758,92,116,1,6,3,3,6,3,4,"High",-5,5
"5418",31,174,0,0.78922,49,31,3,7,2,4,6,4,4,"High",-4,4
"5419",31,175,0,1.3205,51,94,10,6,1,4,5,4,4,"High",4,4
"5420",31,176,1,0.95051,116,49,6,3,4,3,7,4,4,"High",3,3
"5421",31,177,0,1.5022,113,62,10,10,2,3,5,3,4,"High",0,0
"5422",31,178,1,1.0167,8,49,3,3,4,4,8,4,4,"High",0,0
"5423",31,179,1,0.98218,3,60,5,1,3,4,7,3,4,"High",4,4
"5424",31,180,1,1.1152,11,4,3,3,3,3,6,3,4,"High",0,0
"5425",31,181,1,1.5824,66,51,9,10,4,2,6,4,4,"High",-1,1
"5426",31,182,1,0.76229,18,3,1,5,4,4,8,4,4,"High",-4,4
"5427",31,183,1,3.3379,113,50,10,10,3,3,6,3,4,"High",0,0
"5428",31,184,0,0.7413,92,82,1,3,4,1,5,1,4,"High",-2,2
"5429",31,185,0,1.2711,51,12,10,8,3,4,7,4,4,"High",2,2
"5430",31,186,0,0.63664,65,62,10,10,4,4,8,4,4,"High",0,0
"5431",31,187,1,0.89145,50,51,10,10,4,4,8,4,4,"High",0,0
"5432",31,188,0,0.92207,82,11,3,3,2,4,6,4,4,"High",0,0
"5433",31,189,0,1.2421,82,4,3,3,3,4,7,4,4,"High",0,0
"5434",32,1,1,1.0322,102,115,4,4,0,0,0,0,4,"Low",0,0
"5435",32,2,1,2.1181,17,117,2,5,0,0,0,0,4,"Low",-3,3
"5436",32,3,0,2.3438,128,48,1,2,0,0,0,0,4,"Low",-1,1
"5437",32,4,1,0.85625,78,48,7,2,0,1,1,0,4,"Low",5,5
"5438",32,5,1,0.84118,106,100,2,2,0,0,0,0,4,"Low",0,0
"5439",32,6,0,2.0217,53,110,2,1,0,0,0,0,4,"Low",1,1
"5440",32,7,1,0.76121,77,138,5,6,0,0,0,0,4,"Low",-1,1
"5441",32,8,0,2.0147,61,70,1,5,0,0,0,0,4,"Low",-4,4
"5442",32,9,1,1.3274,27,64,5,1,0,0,0,0,4,"Low",4,4
"5443",32,10,0,1.7887,60,48,1,2,0,2,2,2,4,"Low",-1,1
"5444",32,11,0,1.5136,116,117,3,5,0,1,1,1,4,"Low",-2,2
"5445",32,12,0,1.8607,63,102,1,4,0,1,1,1,4,"Low",-3,3
"5446",32,13,1,1.1808,100,27,2,5,1,1,2,1,4,"Low",-3,3
"5447",32,14,1,1.017,106,60,2,1,1,1,2,1,4,"Low",1,1
"5448",32,15,0,1.0224,64,134,1,6,1,0,1,0,4,"Low",-5,5
"5449",32,16,0,0.95749,63,77,1,5,1,1,2,1,4,"Low",-4,4
"5450",32,17,1,2.2391,33,21,1,1,0,0,0,0,4,"Low",0,0
"5451",32,18,0,1.271,66,138,1,6,0,1,1,1,4,"Low",-5,5
"5452",32,19,1,1.3235,116,61,3,1,1,1,2,1,4,"Low",2,2
"5453",32,20,1,2.3018,42,141,2,2,0,0,0,0,4,"Low",0,0
"5454",32,21,1,1.1291,63,62,1,2,2,0,2,2,4,"Low",-1,1
"5455",32,22,0,1.7306,64,102,1,4,2,2,4,2,4,"Low",-3,3
"5456",32,23,0,1.1367,15,78,4,7,0,1,1,1,4,"Low",-3,3
"5457",32,24,1,2.0154,17,22,2,3,1,0,1,1,4,"Low",-1,1
"5458",32,25,0,1.5179,143,17,2,2,0,2,2,2,4,"Low",0,0
"5459",32,26,1,1.2394,93,42,3,2,0,1,1,0,4,"Low",1,1
"5460",32,27,0,1.2204,60,117,1,5,2,2,4,2,4,"Low",-4,4
"5461",32,28,1,0.98924,100,115,2,4,2,1,3,2,4,"Low",-2,2
"5462",32,29,0,1.326,95,15,1,4,0,1,1,1,4,"Low",-3,3
"5463",32,30,1,2.3046,128,60,1,1,1,3,4,1,4,"Low",0,0
"5464",32,31,1,2.5149,8,128,3,1,0,2,2,0,4,"Low",2,2
"5465",32,32,1,1.2182,68,42,2,2,0,2,2,0,4,"Low",0,0
"5466",32,33,0,1.4841,21,133,1,2,1,0,1,0,4,"Low",-1,1
"5467",32,34,0,1.157,108,100,3,2,0,3,3,3,4,"Low",1,1
"5468",32,35,1,1.2773,138,103,6,4,2,0,2,2,4,"Low",2,2
"5469",32,36,1,2.0776,22,62,3,2,1,1,2,1,4,"Low",1,1
"5470",32,37,0,1.7656,17,63,2,1,3,3,6,3,4,"High",1,1
"5471",32,38,1,1.3823,21,53,1,2,2,1,3,2,4,"Low",-1,1
"5472",32,39,1,2.5305,103,21,4,1,1,3,4,1,4,"Low",3,3
"5473",32,40,0,2.2416,53,15,2,4,2,2,4,2,4,"Low",-2,2
"5474",32,41,0,0.83333,108,77,3,5,1,2,3,2,4,"Low",-2,2
"5475",32,42,0,1.9753,61,60,1,1,2,4,6,4,4,"High",0,0
"5476",32,43,0,0.76754,64,134,1,6,3,1,4,1,4,"Low",-5,5
"5477",32,44,1,1.8308,70,33,5,1,1,1,2,1,4,"Low",4,4
"5478",32,45,0,1.8102,62,8,2,3,2,1,3,1,4,"Low",-1,1
"5479",32,46,0,2.3528,66,128,1,1,1,3,4,3,4,"Low",0,0
"5480",32,47,0,1.8781,21,128,1,1,4,4,8,4,4,"High",0,0
"5481",32,48,1,2.0562,141,17,2,2,1,4,5,1,4,"High",0,0
"5482",32,49,0,2.0751,33,141,1,2,2,2,4,2,4,"Low",-1,1
"5483",32,50,0,2.2796,95,82,1,3,1,0,1,0,4,"Low",-2,2
"5484",32,51,0,0.92259,70,103,5,4,2,2,4,2,4,"Low",1,1
"5485",32,52,0,1.5399,48,79,2,3,3,0,3,0,4,"Low",-1,1
"5486",32,53,0,1.0373,110,106,1,2,1,2,3,2,4,"Low",-1,1
"5487",32,54,1,1.216,48,66,2,1,4,2,6,4,4,"High",1,1
"5488",32,55,1,0.7908,77,141,5,2,3,3,6,3,4,"High",3,3
"5489",32,56,1,1.7153,33,103,1,4,3,3,6,3,4,"High",-3,3
"5490",32,57,1,1.5743,27,61,5,1,2,3,5,2,4,"High",4,4
"5491",32,58,0,1.8254,116,15,3,4,2,3,5,3,4,"High",-1,1
"5492",32,59,1,2.6695,110,133,1,2,2,1,3,2,4,"Low",-1,1
"5493",32,60,0,1.1762,110,70,1,5,3,3,6,3,4,"High",-4,4
"5494",32,61,1,2.246,102,27,4,5,3,3,6,3,4,"High",-1,1
"5495",32,62,0,0.58409,22,100,3,2,2,4,6,4,4,"High",1,1
"5496",32,63,1,1.0323,93,108,3,3,1,2,3,1,4,"Low",0,0
"5497",32,64,1,1.317,18,62,4,2,0,3,3,0,4,"Low",2,2
"5498",32,65,1,1.0612,15,61,4,1,4,4,8,4,4,"High",3,3
"5499",32,66,1,0.88388,102,115,4,4,4,2,6,4,4,"High",0,0
"5500",32,67,0,1.1891,68,27,2,5,1,4,5,4,4,"High",-3,3
"5501",32,68,1,2.4807,78,42,7,2,2,3,5,2,4,"High",5,5
"5502",32,69,0,1.1238,64,138,1,6,4,3,7,3,4,"High",-5,5
"5503",32,70,0,1.182,62,106,2,2,4,3,7,3,4,"High",0,0
"5504",32,71,0,1.582,42,70,2,5,4,4,8,4,4,"High",-3,3
"5505",32,72,1,1.2429,39,53,2,2,0,3,3,0,4,"Low",0,0
"5506",32,73,0,1.4054,53,117,2,5,4,3,7,3,4,"High",-3,3
"5507",32,74,1,1.242,63,95,1,1,4,2,6,4,4,"High",0,0
"5508",32,75,1,2.4556,8,116,3,3,2,3,5,2,4,"High",0,0
"5509",32,76,0,2.0985,141,103,2,4,4,4,8,4,4,"High",-2,2
"5510",32,77,0,1.6792,133,22,2,3,2,3,5,3,4,"High",-1,1
"5511",32,78,1,1.6038,8,116,3,3,3,4,7,3,4,"High",0,0
"5512",32,79,1,0.79418,77,82,5,3,4,1,5,4,4,"High",2,2
"5513",32,80,1,0.73766,93,133,3,2,2,3,5,2,4,"High",1,1
"5514",32,81,1,1.404,117,68,5,2,4,2,6,4,4,"High",3,3
"5515",32,82,0,1.17,115,78,4,7,3,3,6,3,4,"High",-3,3
"5516",32,83,1,1.5146,39,22,2,3,1,4,5,1,4,"High",-1,1
"5517",32,84,1,0.63259,78,39,7,2,4,2,6,4,4,"High",5,5
"5518",32,85,1,0.86601,138,108,6,3,4,3,7,4,4,"High",3,3
"5519",32,86,1,1.2694,115,8,4,3,4,4,8,4,4,"High",1,1
"5520",32,87,1,1.9141,39,110,2,1,3,4,7,3,4,"High",1,1
"5521",32,88,0,1.0422,133,18,2,4,4,1,5,1,4,"High",-2,2
"5522",32,89,1,1.6648,18,82,4,3,2,2,4,2,4,"Low",1,1
"5523",32,90,0,1.2436,95,93,1,3,3,3,6,3,4,"High",-2,2
"5524",32,91,0,1.9851,79,18,3,4,1,3,4,3,4,"Low",-1,1
"5525",32,92,0,1.3202,33,134,1,6,4,2,6,2,4,"High",-5,5
"5526",32,93,1,1.0062,82,95,3,1,3,4,7,3,4,"High",2,2
"5527",32,94,1,0.96301,82,108,3,3,4,4,8,4,4,"High",0,0
"5528",32,95,0,1.1202,66,18,1,4,3,4,7,4,4,"High",-3,3
"5529",32,96,1,0.67558,134,39,6,2,3,4,7,3,4,"High",4,4
"5530",32,97,1,0.59262,134,93,6,3,4,4,8,4,4,"High",3,3
"5531",32,98,0,1.0552,66,106,1,2,4,4,8,4,4,"High",-1,1
"5532",32,99,0,1.2569,143,79,2,3,1,2,3,2,4,"Low",-1,1
"5533",32,100,1,0.98144,79,143,3,2,3,2,5,3,4,"High",1,1
"5534",32,101,0,0.64575,143,79,2,3,3,4,7,4,4,"High",-1,1
"5535",32,102,1,1.3474,68,143,2,2,3,4,7,3,4,"High",0,0
"5536",33,1,1,0.97348,27,83,3,3,0,0,0,0,3,"Low",0,0
"5537",33,2,0,2.6781,37,124,3,4,0,0,0,0,3,"Low",-1,1
"5538",33,3,0,2.6033,125,55,5,4,0,0,0,0,3,"Low",1,1
"5539",33,4,1,3.0603,104,45,2,6,0,0,0,0,3,"Low",-4,4
"5540",33,5,0,1.2076,42,88,4,6,0,0,0,0,3,"Low",-2,2
"5541",33,6,1,0.74624,93,136,2,1,0,0,0,0,3,"Low",1,1
"5542",33,7,0,0.67121,83,96,3,6,1,0,1,0,3,"Low",-3,3
"5543",33,8,0,0.64917,141,58,2,5,0,0,0,0,3,"Low",-3,3
"5544",33,9,1,0.87539,55,31,4,6,1,0,1,1,3,"Low",-2,2
"5545",33,10,0,0.57521,111,9,5,5,0,0,0,0,3,"Low",0,0
"5546",33,11,1,1.248,30,140,5,3,0,0,0,0,3,"Low",2,2
"5547",33,12,0,0.87197,44,112,3,6,0,0,0,0,3,"Low",-3,3
"5548",33,13,0,0.72829,25,117,4,8,0,0,0,0,3,"Low",-4,4
"5549",33,14,0,3.0805,46,134,4,1,0,0,0,0,3,"Low",3,3
"5550",33,15,0,1.8374,105,119,4,6,0,0,0,0,3,"Low",-2,2
"5551",33,16,0,0.95229,76,111,6,5,0,1,1,1,3,"Low",1,1
"5552",33,17,0,1.189,87,26,2,5,0,0,0,0,3,"Low",-3,3
"5553",33,18,1,1.6315,16,56,3,3,0,0,0,0,3,"Low",0,0
"5554",33,19,0,1.7423,1,113,5,3,0,0,0,0,3,"Low",2,2
"5555",33,20,1,0.8474,31,83,6,3,1,2,3,1,3,"Low",3,3
"5556",33,21,1,1.1429,52,22,2,1,0,0,0,0,3,"Low",1,1
"5557",33,22,0,1.3483,56,134,3,1,1,1,2,1,3,"Low",2,2
"5558",33,23,0,1.9439,68,100,3,4,0,0,0,0,3,"Low",-1,1
"5559",33,24,1,1.24,32,36,3,3,0,0,0,0,3,"Low",0,0
"5560",33,25,1,2.5164,140,93,3,2,1,1,2,1,3,"Low",1,1
"5561",33,26,0,0.76667,136,98,1,2,1,0,1,0,3,"Low",-1,1
"5562",33,27,0,1.1051,66,122,5,10,0,0,0,0,3,"Low",-5,5
"5563",33,28,1,2.9511,143,69,1,2,0,0,0,0,3,"Low",-1,1
"5564",33,29,1,0.57064,25,106,4,1,1,0,1,1,3,"Low",3,3
"5565",33,30,1,2.1094,97,106,2,1,0,1,1,0,3,"Low",1,1
"5566",33,31,0,0.96237,73,36,5,3,0,1,1,1,3,"Low",2,2
"5567",33,32,0,0.54956,2,29,3,3,0,0,0,0,3,"Low",0,0
"5568",33,33,0,0.89081,38,51,4,5,0,0,0,0,3,"Low",-1,1
"5569",33,34,1,2.4743,136,109,1,1,2,0,2,2,3,"Low",0,0
"5570",33,35,0,0.65822,106,27,1,3,2,1,3,1,3,"Low",-2,2
"5571",33,36,0,1.1707,32,98,3,2,1,1,2,1,3,"Low",1,1
"5572",33,37,1,1.0032,67,65,6,3,0,0,0,0,3,"Low",3,3
"5573",33,38,0,1.043,42,47,4,1,1,0,1,0,3,"Low",3,3
"5574",33,39,0,1.1533,114,29,6,3,0,1,1,1,3,"Low",3,3
"5575",33,40,0,1.2958,98,134,2,1,2,2,4,2,3,"High",1,1
"5576",33,41,0,0.82826,21,31,5,6,0,2,2,2,3,"Low",-1,1
"5577",33,42,0,1.3491,109,62,1,2,1,0,1,0,3,"Low",-1,1
"5578",33,43,0,0.67273,9,30,5,5,1,1,2,1,3,"Low",0,0
"5579",33,44,0,2.1955,92,58,5,5,0,1,1,1,3,"Low",0,0
"5580",33,45,0,1.0688,44,105,3,4,1,1,2,1,3,"Low",-1,1
"5581",33,46,0,1.7422,85,76,4,6,0,1,1,1,3,"Low",-2,2
"5582",33,47,1,1.6156,35,114,5,6,0,1,1,0,3,"Low",-1,1
"5583",33,48,0,0.76888,68,27,3,3,1,2,3,2,3,"Low",0,0
"5584",33,49,1,0.71289,34,118,8,6,0,0,0,0,3,"Low",2,2
"5585",33,50,0,0.84685,73,30,5,5,1,2,3,2,3,"Low",0,0
"5586",33,51,1,1.3245,39,136,3,1,0,3,3,0,3,"Low",2,2
"5587",33,52,1,0.48229,36,74,3,5,2,0,2,2,3,"Low",-2,2
"5588",33,53,0,1.0138,96,105,6,4,1,2,3,2,3,"Low",2,2
"5589",33,54,1,1.1538,74,106,5,1,1,3,4,1,3,"High",4,4
"5590",33,55,1,3.737,92,36,5,3,1,3,4,1,3,"High",2,2
"5591",33,56,1,1.0266,129,46,5,4,0,1,1,0,3,"Low",1,1
"5592",33,57,0,1.8988,106,45,1,6,4,1,5,1,3,"High",-5,5
"5593",33,58,1,0.98329,98,51,2,5,3,1,4,3,3,"High",-3,3
"5594",33,59,1,0.66121,1,73,5,5,1,2,3,1,3,"Low",0,0
"5595",33,60,0,2.3992,141,128,2,3,1,0,1,0,3,"Low",-1,1
"5596",33,61,0,1.1161,141,18,2,1,2,0,2,0,3,"Low",1,1
"5597",33,62,0,1.5369,50,33,3,3,0,0,0,0,3,"Low",0,0
"5598",33,63,0,1.1168,114,20,6,6,2,0,2,0,3,"Low",0,0
"5599",33,64,0,0.97493,6,92,2,5,0,2,2,2,3,"Low",-3,3
"5600",33,65,1,1.3937,125,57,5,2,1,0,1,1,3,"Low",3,3
"5601",33,66,1,0.77027,18,42,1,4,1,2,3,1,3,"Low",-3,3
"5602",33,67,1,1.4083,65,121,3,5,1,0,1,1,3,"Low",-2,2
"5603",33,68,1,0.60249,146,67,10,6,0,1,1,0,3,"Low",4,4
"5604",33,69,1,0.5753,41,68,5,3,0,2,2,0,3,"Low",2,2
"5605",33,70,0,1.5166,98,42,2,4,4,3,7,3,3,"High",-2,2
"5606",33,71,0,1.1526,102,133,5,1,0,0,0,0,3,"Low",4,4
"5607",33,72,0,0.58277,113,88,3,6,1,1,2,1,3,"Low",-3,3
"5608",33,73,1,1.5181,57,26,2,5,1,1,2,1,3,"Low",-3,3
"5609",33,74,0,0.61255,60,26,2,5,0,2,2,2,3,"Low",-3,3
"5610",33,75,0,1.0674,108,29,4,3,0,2,2,2,3,"Low",1,1
"5611",33,76,1,0.76483,49,6,4,2,0,1,1,0,3,"Low",2,2
"5612",33,77,1,1.2508,51,124,5,4,2,1,3,2,3,"Low",1,1
"5613",33,78,0,0.942,46,58,4,5,2,2,4,2,3,"High",-1,1
"5614",33,79,0,1.0135,108,90,4,1,1,0,1,0,3,"Low",3,3
"5615",33,80,1,1.1607,50,32,3,3,1,2,3,1,3,"Low",0,0
"5616",33,81,1,1.1354,45,22,6,1,2,1,3,2,3,"Low",5,5
"5617",33,82,1,1.0717,93,115,2,3,2,0,2,2,3,"Low",-1,1
"5618",33,83,1,0.88377,22,109,1,1,2,2,4,2,3,"High",0,0
"5619",33,84,1,1.1018,128,73,3,5,1,3,4,1,3,"High",-2,2
"5620",33,85,0,0.37383,39,109,3,1,1,3,4,3,3,"High",2,2
"5621",33,86,1,0.61181,76,144,6,1,2,0,2,2,3,"Low",5,5
"5622",33,87,0,1.555,32,74,3,5,3,2,5,2,3,"High",-2,2
"5623",33,88,1,0.65189,66,32,5,3,1,4,5,1,3,"High",2,2
"5624",33,89,1,1.1582,115,56,3,3,1,2,3,1,3,"Low",0,0
"5625",33,90,1,0.69265,122,129,10,5,1,1,2,1,3,"Low",5,5
"5626",33,91,1,1.3952,119,60,6,2,1,1,2,1,3,"Low",4,4
"5627",33,92,0,1.306,54,35,5,5,0,1,1,1,3,"Low",0,0
"5628",33,93,0,1.1202,73,74,5,5,4,3,7,3,3,"High",0,0
"5629",33,94,0,1.0367,140,97,3,2,2,1,3,1,3,"Low",1,1
"5630",33,95,1,1.1429,116,9,9,5,0,2,2,0,3,"Low",4,4
"5631",33,96,1,0.59491,27,39,3,3,3,2,5,3,3,"High",0,0
"5632",33,97,1,1.3024,55,10,4,2,2,0,2,2,3,"Low",2,2
"5633",33,98,0,1.2233,121,27,5,3,1,4,5,4,3,"High",2,2
"5634",33,99,1,0.67707,26,39,5,3,3,3,6,3,3,"High",2,2
"5635",33,100,1,0.71051,50,124,3,4,2,2,4,2,3,"High",-1,1
"5636",33,101,1,0.95374,89,128,6,3,0,2,2,0,3,"Low",3,3
"5637",33,102,0,1.3226,50,85,3,4,3,1,4,1,3,"High",-1,1
"5638",33,103,0,1.0787,143,134,1,1,1,3,4,3,3,"High",0,0
"5639",33,104,1,0.61128,133,42,1,4,1,4,5,1,3,"High",-3,3
"5640",33,105,1,0.999,90,76,1,6,1,3,4,1,3,"High",-5,5
"5641",33,106,1,0.71664,90,69,1,2,2,1,3,2,3,"Low",-1,1
"5642",33,107,0,1.1595,76,33,6,3,4,1,5,1,3,"High",3,3
"5643",33,108,1,0.66734,41,133,5,1,1,2,3,1,3,"Low",4,4
"5644",33,109,1,0.56893,35,26,5,5,2,4,6,2,3,"High",0,0
"5645",33,110,1,2.817,93,90,2,1,3,3,6,3,3,"High",1,1
"5646",33,111,0,0.70752,112,102,6,5,1,1,2,1,3,"Low",1,1
"5647",33,112,1,1.2804,97,44,2,3,2,2,4,2,3,"High",-1,1
"5648",33,113,0,1.0529,22,47,1,1,3,1,4,1,3,"High",0,0
"5649",33,114,0,1.2018,87,137,2,2,1,0,1,0,3,"Low",0,0
"5650",33,115,1,0.98453,69,91,2,1,2,0,2,2,3,"Low",1,1
"5651",33,116,0,1.8259,1,92,5,5,2,3,5,3,3,"High",0,0
"5652",33,117,1,1.3578,125,92,5,5,2,4,6,2,3,"High",0,0
"5653",33,118,0,0.58587,17,89,6,6,0,1,1,1,3,"Low",0,0
"5654",33,119,1,0.92747,45,6,6,2,3,2,5,3,3,"High",4,4
"5655",33,120,0,1.1286,133,25,1,4,3,2,5,2,3,"High",-3,3
"5656",33,121,1,1.1919,128,97,3,2,3,3,6,3,3,"High",1,1
"5657",33,122,0,0.95601,70,55,4,4,0,3,3,3,3,"Low",0,0
"5658",33,123,0,1.2048,59,125,1,5,0,3,3,3,3,"Low",-4,4
"5659",33,124,1,0.79488,68,94,3,5,3,0,3,3,3,"Low",-2,2
"5660",33,125,1,0.77278,101,17,6,6,0,1,1,0,3,"Low",0,0
"5661",33,126,0,0.83752,124,63,4,6,3,0,3,0,3,"Low",-2,2
"5662",33,127,1,1.1886,113,128,3,3,2,4,6,2,3,"High",0,0
"5663",33,128,1,1.3338,108,138,4,2,2,0,2,2,3,"Low",2,2
"5664",33,129,1,1.1063,140,50,3,3,3,4,7,3,3,"High",0,0
"5665",33,130,0,0.8551,97,35,2,5,4,3,7,3,3,"High",-3,3
"5666",33,131,0,1.4669,138,38,2,4,1,1,2,1,3,"Low",-2,2
"5667",33,132,0,1.5589,138,104,2,2,2,1,3,1,3,"Low",0,0
"5668",33,133,0,0.83393,137,138,2,2,1,3,4,3,3,"High",0,0
"5669",33,134,1,2.2799,14,59,3,1,0,1,1,0,3,"Low",2,2
"5670",33,135,0,0.70868,121,18,5,1,2,2,4,2,3,"High",4,4
"5671",33,136,1,1.4238,55,47,4,1,4,2,6,4,3,"High",3,3
"5672",33,137,1,1.122,36,59,3,1,4,2,6,4,3,"High",2,2
"5673",33,138,0,0.76576,89,146,6,10,2,1,3,1,3,"Low",-4,4
"5674",33,139,0,1.0033,2,111,3,5,1,2,3,2,3,"Low",-2,2
"5675",33,140,1,1.4707,74,17,5,6,4,2,6,4,3,"High",-1,1
"5676",33,141,1,0.72469,58,93,5,2,3,4,7,3,3,"High",3,3
"5677",33,142,1,1.5233,124,69,4,2,4,3,7,4,3,"High",2,2
"5678",33,143,0,0.89684,143,45,1,6,2,4,6,4,3,"High",-5,5
"5679",33,144,0,1.6148,141,14,2,3,3,1,4,1,3,"High",-1,1
"5680",33,145,1,0.74959,63,31,6,6,1,3,4,1,3,"High",0,0
"5681",33,146,1,0.83765,134,69,1,2,4,4,8,4,3,"High",-1,1
"5682",33,147,0,1.0616,125,30,5,5,4,3,7,3,3,"High",0,0
"5683",33,148,1,0.73058,25,87,4,2,3,2,5,3,3,"High",2,2
"5684",33,149,1,1.1472,1,57,5,2,3,2,5,3,3,"High",3,3
"5685",33,150,1,1.0271,38,104,4,2,2,2,4,2,3,"High",2,2
"5686",33,151,0,0.65768,138,51,2,5,4,3,7,3,3,"High",-3,3
"5687",33,152,0,0.64652,6,104,2,2,3,3,6,3,3,"High",0,0
"5688",33,153,0,1.4414,143,70,1,4,3,1,4,1,3,"High",-3,3
"5689",33,154,1,0.94408,87,56,2,3,3,3,6,3,3,"High",-1,1
"5690",33,155,0,0.67502,47,46,1,4,3,3,6,3,3,"High",-3,3
"5691",33,156,1,1.1407,85,60,4,2,2,2,4,2,3,"High",2,2
"5692",33,157,0,1.3001,67,119,6,6,2,2,4,2,3,"High",0,0
"5693",33,158,1,1.7534,60,90,2,1,3,4,7,3,3,"High",1,1
"5694",33,159,1,0.82021,41,105,5,4,2,3,5,2,3,"High",1,1
"5695",33,160,1,3.4275,108,87,4,2,3,4,7,3,3,"High",2,2
"5696",33,161,1,0.86161,113,100,3,4,3,1,4,3,3,"High",-1,1
"5697",33,162,0,1.1084,109,39,1,3,4,4,8,4,3,"High",-2,2
"5698",33,163,1,0.58912,113,104,3,2,4,4,8,4,3,"High",1,1
"5699",33,164,0,0.9224,6,58,2,5,4,4,8,4,3,"High",-3,3
"5700",33,165,1,1.4493,119,112,6,6,3,2,5,3,3,"High",0,0
"5701",33,166,1,1.4161,51,14,5,3,4,2,6,4,3,"High",2,2
"5702",33,167,1,0.62671,101,47,6,1,1,4,5,1,3,"High",5,5
"5703",33,168,1,0.76151,114,129,6,5,3,2,5,3,3,"High",1,1
"5704",33,169,1,0.80536,46,111,4,5,4,3,7,4,3,"High",-1,1
"5705",33,170,0,0.46355,96,68,6,3,2,4,6,4,3,"High",3,3
"5706",33,171,0,1.1342,60,30,2,5,4,4,8,4,3,"High",-3,3
"5707",33,172,0,1.2075,70,14,4,3,2,3,5,3,3,"High",1,1
"5708",33,173,0,0.90171,101,118,6,6,2,1,3,1,3,"Low",0,0
"5709",33,174,1,0.92923,57,16,2,3,3,1,4,3,3,"High",-1,1
"5710",33,175,1,0.7807,65,56,3,3,2,4,6,2,3,"High",0,0
"5711",33,176,1,0.62319,118,114,6,6,2,4,6,2,3,"High",0,0
"5712",33,177,0,0.92432,129,35,5,5,3,4,7,4,3,"High",0,0
"5713",33,178,0,0.79809,99,101,3,6,0,3,3,3,3,"Low",-3,3
"5714",33,179,1,0.55802,18,21,1,5,3,1,4,3,3,"High",-4,4
"5715",33,180,1,0.71881,65,18,3,1,3,4,7,3,3,"High",2,2
"5716",33,181,1,0.6421,22,112,1,6,4,3,7,4,3,"High",-5,5
"5717",33,182,1,3.5035,65,9,3,5,4,3,7,4,3,"High",-2,2
"5718",33,183,0,0.93103,14,38,3,4,4,3,7,3,3,"High",-1,1
"5719",33,184,1,0.82548,34,38,8,4,1,4,5,1,3,"High",4,4
"5720",33,185,1,1.7656,103,105,1,4,0,4,4,0,3,"High",-3,3
"5721",33,186,1,0.65243,31,94,6,5,4,1,5,4,3,"High",1,1
"5722",33,187,1,1.1539,118,141,6,2,3,4,7,3,3,"High",4,4
"5723",33,188,0,0.55511,62,63,2,6,1,2,3,2,3,"Low",-4,4
"5724",33,189,1,0.64916,29,136,3,1,3,4,7,3,3,"High",2,2
"5725",33,190,1,1.5685,33,111,3,5,2,4,6,2,3,"High",-2,2
"5726",33,191,1,1.1536,62,1,2,5,2,4,6,2,3,"High",-3,3
"5727",33,192,1,1.0497,67,70,6,4,3,3,6,3,3,"High",2,2
"5728",33,193,1,0.69991,103,10,1,2,1,1,2,1,3,"Low",-1,1
"5729",33,194,0,0.7866,121,63,5,6,3,3,6,3,3,"High",-1,1
"5730",33,195,1,0.60737,118,57,6,2,4,4,8,4,3,"High",4,4
"5731",33,196,1,0.5728,117,70,8,4,1,4,5,1,3,"High",4,4
"5732",33,197,0,1.1254,41,122,5,10,3,2,5,2,3,"High",-5,5
"5733",33,198,1,1.0701,2,10,3,2,2,2,4,2,3,"High",1,1
"5734",33,199,0,0.73152,133,63,1,6,4,4,8,4,3,"High",-5,5
"5735",33,200,0,1.832,83,144,3,1,3,1,4,1,3,"High",2,2
"5736",34,1,0,0.80489,105,45,1,5,0,0,0,0,4,"Low",-4,4
"5737",34,2,0,2.0101,29,102,10,8,0,0,0,0,4,"Low",2,2
"5738",34,3,1,1.0077,102,93,8,4,1,0,1,1,4,"Low",4,4
"5739",34,4,0,0.62132,90,67,5,5,0,0,0,0,4,"Low",0,0
"5740",34,5,0,0.74465,102,29,8,10,2,1,3,1,4,"Low",-2,2
"5741",34,6,1,0.68354,67,41,5,2,1,0,1,1,4,"Low",3,3
"5742",34,7,1,1.2461,93,35,4,6,1,0,1,1,4,"Low",-2,2
"5743",34,8,0,0.73811,93,32,4,4,2,0,2,0,4,"Low",0,0
"5744",34,9,0,1.2195,93,68,4,3,3,0,3,0,4,"Low",1,1
"5745",34,10,0,0.57572,90,68,5,3,1,1,2,1,4,"Low",2,2
"5746",34,11,1,1.0701,45,90,5,5,1,2,3,1,4,"Low",0,0
"5747",34,12,1,0.7385,68,90,3,5,2,3,5,2,4,"High",-2,2
"5748",34,13,1,1.1858,32,93,4,4,1,4,5,1,4,"High",0,0
"5749",34,14,1,1.7345,105,67,1,5,1,2,3,1,4,"Low",-4,4
"5750",34,15,1,1.1119,68,105,3,1,3,2,5,3,4,"High",2,2
"5751",34,16,0,1.1439,67,29,5,10,3,2,5,2,4,"High",-5,5
"5752",34,17,0,0.59346,35,100,6,10,1,0,1,0,4,"Low",-4,4
"5753",34,18,0,0.65577,45,17,5,8,2,0,2,0,4,"Low",-3,3
"5754",34,19,0,1.4984,90,68,5,3,4,4,8,4,4,"High",2,2
"5755",34,20,0,1.6532,41,32,2,4,1,2,3,2,4,"Low",-2,2
"5756",34,21,0,0.95655,35,67,6,5,2,4,6,4,4,"High",1,1
"5757",34,22,0,0.62069,41,32,2,4,2,3,5,3,4,"High",-2,2
"5758",34,23,0,0.85798,41,35,2,6,3,3,6,3,4,"High",-4,4
"5759",34,24,0,1.068,35,102,6,8,4,3,7,3,4,"High",-2,2
"5760",34,25,1,1.2723,102,32,8,4,4,4,8,4,4,"High",4,4
"5761",34,26,0,0.65029,17,100,8,10,1,1,2,1,4,"Low",-2,2
"5762",34,27,1,0.83612,31,41,2,2,0,4,4,0,4,"Low",0,0
"5763",34,28,0,1.1783,29,17,10,8,3,2,5,2,4,"High",2,2
"5764",34,29,1,1.3776,100,17,10,8,2,3,5,2,4,"High",2,2
"5765",34,30,0,1.0524,45,31,5,2,3,1,4,1,4,"Low",3,3
"5766",34,31,0,0.66195,17,100,8,10,4,3,7,3,4,"High",-2,2
"5767",34,32,0,2.4323,105,31,1,2,3,2,5,2,4,"High",-1,1
"5768",34,33,0,1.146,45,100,5,10,4,4,8,4,4,"High",-5,5
"5769",34,34,0,0.9473,105,31,1,2,4,3,7,3,4,"High",-1,1
"5770",35,1,0,1.1494,104,29,6,2,0,0,0,0,4,"Low",4,4
"5771",35,2,1,1.3112,90,94,1,1,0,0,0,0,4,"Low",0,0
"5772",35,3,0,1.1099,124,123,1,5,0,0,0,0,4,"Low",-4,4
"5773",35,4,1,1.7325,21,2,4,1,0,0,0,0,4,"Low",3,3
"5774",35,5,1,4.7651,21,121,4,1,1,0,1,1,4,"Low",3,3
"5775",35,6,1,1.2288,31,52,5,2,0,0,0,0,4,"Low",3,3
"5776",35,7,0,1.5323,25,96,2,4,0,0,0,0,4,"Low",-2,2
"5777",35,8,0,2.3602,25,112,2,3,1,0,1,0,4,"Low",-1,1
"5778",35,9,1,1.319,76,94,1,1,0,1,1,0,4,"Low",0,0
"5779",35,10,0,1.1603,25,87,2,7,2,0,2,0,4,"Low",-5,5
"5780",35,11,0,1.0703,134,123,1,5,0,1,1,1,4,"Low",-4,4
"5781",35,12,0,1.2142,56,45,1,5,0,0,0,0,4,"Low",-4,4
"5782",35,13,0,2.0679,134,68,1,1,1,0,1,0,4,"Low",0,0
"5783",35,14,0,1.9064,108,109,1,1,0,0,0,0,4,"Low",0,0
"5784",35,15,0,1.0627,52,45,2,5,1,1,2,1,4,"Low",-3,3
"5785",35,16,0,1.2174,56,39,1,1,1,0,1,0,4,"Low",0,0
"5786",35,17,1,1.6308,112,117,3,1,1,0,1,1,4,"Low",2,2
"5787",35,18,0,1.4458,113,31,1,5,0,1,1,1,4,"Low",-4,4
"5788",35,19,0,0.72338,56,75,1,1,2,0,2,0,4,"Low",0,0
"5789",35,20,0,1.9473,77,35,3,6,0,0,0,0,4,"Low",-3,3
"5790",35,21,1,1.5775,111,55,1,3,0,0,0,0,4,"Low",-2,2
"5791",35,22,1,0.87171,116,88,7,4,0,0,0,0,4,"Low",3,3
"5792",35,23,0,1.9869,88,46,4,7,1,0,1,0,4,"Low",-3,3
"5793",35,24,0,2.1426,75,125,1,4,1,0,1,0,4,"Low",-3,3
"5794",35,25,1,1.2397,121,104,1,6,1,1,2,1,4,"Low",-5,5
"5795",35,26,1,2.0804,21,112,4,3,2,2,4,2,4,"Low",1,1
"5796",35,27,1,1.0333,45,144,5,1,2,0,2,2,4,"Low",4,4
"5797",35,28,1,1.6364,124,114,1,1,1,0,1,1,4,"Low",0,0
"5798",35,29,1,1.103,90,21,1,4,1,3,4,1,4,"Low",-3,3
"5799",35,30,0,1.0953,52,111,2,1,2,1,3,1,4,"Low",1,1
"5800",35,31,0,1.4109,122,34,3,3,0,0,0,0,4,"Low",0,0
"5801",35,32,1,1.1495,73,77,2,3,0,1,1,0,4,"Low",-1,1
"5802",35,33,0,1.3761,62,90,4,1,0,2,2,2,4,"Low",3,3
"5803",35,34,0,1.0597,27,41,3,8,0,0,0,0,4,"Low",-5,5
"5804",35,35,1,1.1262,18,114,5,1,0,1,1,0,4,"Low",4,4
"5805",35,36,0,2.2531,2,73,1,2,1,1,2,1,4,"Low",-1,1
"5806",35,37,0,1.0068,108,63,1,5,1,0,1,0,4,"Low",-4,4
"5807",35,38,1,1.371,21,50,4,2,4,0,4,4,4,"Low",2,2
"5808",35,39,0,1.6959,73,31,2,5,2,2,4,2,4,"Low",-3,3
"5809",35,40,0,1.4293,38,41,5,8,0,1,1,1,4,"Low",-3,3
"5810",35,41,1,1.2819,124,108,1,1,2,2,4,2,4,"Low",0,0
"5811",35,42,1,1.0492,116,125,7,4,1,1,2,1,4,"Low",3,3
"5812",35,43,1,1.2726,36,62,1,4,0,1,1,0,4,"Low",-3,3
"5813",35,44,1,2.2334,113,104,1,6,1,2,3,1,4,"Low",-5,5
"5814",35,45,1,1.5396,73,16,2,1,3,0,3,3,4,"Low",1,1
"5815",35,46,1,2.0782,50,58,2,2,1,0,1,1,4,"Low",0,0
"5816",35,47,0,1.2404,62,88,4,4,2,2,4,2,4,"Low",0,0
"5817",35,48,0,2.0364,104,27,6,3,3,1,4,1,4,"Low",3,3
"5818",35,49,1,1.0997,29,121,2,1,1,2,3,1,4,"Low",1,1
"5819",35,50,1,1.2772,16,134,1,1,1,2,3,1,4,"Low",0,0
"5820",35,51,0,1.4247,101,27,1,3,0,2,2,2,4,"Low",-2,2
"5821",35,52,0,1.2661,87,45,7,5,1,3,4,3,4,"Low",2,2
"5822",35,53,1,1.2022,62,104,4,6,3,4,7,3,4,"High",-2,2
"5823",35,54,1,1.2089,125,134,4,1,2,3,5,2,4,"High",3,3
"5824",35,55,1,1.2903,50,100,2,1,2,0,2,2,4,"Low",1,1
"5825",35,56,1,1.4311,101,85,1,3,1,0,1,1,4,"Low",-2,2
"5826",35,57,0,1.389,92,117,1,1,0,1,1,1,4,"Low",0,0
"5827",35,58,0,0.93518,69,51,1,1,0,0,0,0,4,"Low",0,0
"5828",35,59,0,1.0585,144,47,1,1,1,0,1,0,4,"Low",0,0
"5829",35,60,1,0.99607,35,55,6,3,1,1,2,1,4,"Low",3,3
"5830",35,61,0,0.88381,100,24,1,1,1,0,1,0,4,"Low",0,0
"5831",35,62,0,0.91121,55,87,3,7,2,2,4,2,4,"Low",-4,4
"5832",35,63,1,2.0745,134,111,1,1,4,2,6,4,4,"High",0,0
"5833",35,64,1,1.1173,101,85,1,3,2,1,3,2,4,"Low",-2,2
"5834",35,65,1,2.1535,31,34,5,3,3,1,4,3,4,"Low",2,2
"5835",35,66,1,1.1662,112,31,3,5,3,4,7,3,4,"High",-2,2
"5836",35,67,0,1.3683,39,76,1,1,1,1,2,1,4,"Low",0,0
"5837",35,68,0,1.9006,122,96,3,4,1,1,2,1,4,"Low",-1,1
"5838",35,69,1,1.9228,122,47,3,1,2,1,3,2,4,"Low",2,2
"5839",35,70,1,1.5975,27,111,3,1,3,3,6,3,4,"High",2,2
"5840",35,71,1,0.95695,112,70,3,1,4,0,4,4,4,"Low",2,2
"5841",35,72,0,1.164,121,88,1,4,3,3,6,3,4,"High",-3,3
"5842",35,73,1,1.1706,16,124,1,1,2,3,5,2,4,"High",0,0
"5843",35,74,0,1.0817,111,34,1,3,4,2,6,2,4,"High",-2,2
"5844",35,75,0,1.1612,62,63,4,5,4,1,5,1,4,"High",-1,1
"5845",35,76,0,1.0513,70,90,1,1,1,3,4,3,4,"Low",0,0
"5846",35,77,1,1.1885,125,100,4,1,3,2,5,3,4,"High",3,3
"5847",35,78,0,1.5762,52,122,2,3,3,3,6,3,4,"High",-1,1
"5848",35,79,1,0.79933,36,68,1,1,1,1,2,1,4,"Low",0,0
"5849",35,80,0,0.70565,50,27,2,3,3,4,7,4,4,"High",-1,1
"5850",35,81,1,0.81838,35,39,6,1,2,2,4,2,4,"Low",5,5
"5851",35,82,1,1.4797,75,92,1,1,2,1,3,2,4,"Low",0,0
"5852",35,83,1,0.71813,45,75,5,1,4,3,7,4,4,"High",4,4
"5853",35,84,0,1.4518,129,96,1,4,0,2,2,2,4,"Low",-3,3
"5854",35,85,1,0.92705,122,108,3,1,4,3,7,4,4,"High",2,2
"5855",35,86,1,0.76664,34,35,3,6,3,3,6,3,4,"High",-3,3
"5856",35,87,0,1.3859,75,146,1,3,4,0,4,0,4,"Low",-2,2
"5857",35,88,0,1.3053,99,30,1,3,0,0,0,0,4,"Low",-2,2
"5858",35,89,1,1.3234,34,100,3,1,4,3,7,4,4,"High",2,2
"5859",35,90,1,1.0788,96,144,4,1,3,2,5,3,4,"High",3,3
"5860",35,91,0,0.8195,77,117,3,1,2,2,4,2,4,"Low",2,2
"5861",35,92,0,1.5322,2,73,1,2,2,4,6,4,4,"High",-1,1
"5862",35,93,0,0.99154,56,47,1,1,3,2,5,2,4,"High",0,0
"5863",35,94,1,0.93042,123,113,5,1,2,2,4,2,4,"Low",4,4
"5864",35,95,1,0.84486,90,55,1,3,4,3,7,4,4,"High",-2,2
"5865",35,96,0,1.0128,85,83,3,7,2,0,2,0,4,"Low",-4,4
"5866",35,97,1,1.2786,56,77,1,3,4,3,7,4,4,"High",-2,2
"5867",35,98,1,0.65779,30,92,3,1,1,2,3,1,4,"Low",2,2
"5868",35,99,1,0.92542,121,16,1,1,4,3,7,4,4,"High",0,0
"5869",35,100,1,1.2548,113,99,1,1,3,1,4,3,4,"Low",0,0
"5870",35,101,1,0.90433,50,108,2,1,4,4,8,4,4,"High",1,1
"5871",35,102,1,0.77524,119,18,8,5,0,1,1,0,4,"Low",3,3
"5872",35,103,1,1.4143,124,100,1,1,4,4,8,4,4,"High",0,0
"5873",35,104,1,0.63064,88,51,4,1,4,1,5,4,4,"High",3,3
"5874",35,105,1,2.4833,101,70,1,1,3,2,5,3,4,"High",0,0
"5875",35,106,0,1.3352,2,125,1,4,3,4,7,4,4,"High",-3,3
"5876",35,107,0,1.1868,99,94,1,1,2,2,4,2,4,"Low",0,0
"5877",35,108,0,1.2496,16,39,1,1,4,3,7,3,4,"High",0,0
"5878",35,109,1,1.1396,85,18,3,5,3,2,5,3,4,"High",-2,2
"5879",35,110,1,0.96355,123,20,5,4,3,0,3,3,4,"Low",1,1
"5880",35,111,0,0.82108,52,144,2,1,4,3,7,3,4,"High",1,1
"5881",35,112,1,0.92996,41,77,8,3,2,4,6,2,4,"High",5,5
"5882",35,113,1,1.0021,85,68,3,1,4,2,6,4,4,"High",2,2
"5883",35,114,1,0.86869,146,84,3,8,1,0,1,1,4,"Low",-5,5
"5884",35,115,0,1.028,68,63,1,5,3,2,5,2,4,"High",-4,4
"5885",35,116,0,1.2341,18,39,5,1,3,4,7,4,4,"High",4,4
"5886",35,117,0,0.70399,83,119,7,8,1,1,2,1,4,"Low",-1,1
"5887",35,118,0,1.5461,25,59,2,2,3,0,3,0,4,"Low",0,0
"5888",35,119,0,1.2215,96,29,4,2,4,2,6,2,4,"High",2,2
"5889",35,120,1,1.3136,36,55,1,3,2,4,6,2,4,"High",-2,2
"5890",35,121,1,1.4069,46,30,7,3,1,2,3,1,4,"Low",4,4
"5891",35,122,1,1.5037,25,113,2,1,4,4,8,4,4,"High",1,1
"5892",35,123,0,1.1803,68,92,1,1,4,3,7,3,4,"High",0,0
"5893",35,124,1,1.3639,76,35,1,6,2,4,6,2,4,"High",-5,5
"5894",35,125,0,0.99919,144,101,1,1,4,4,8,4,4,"High",0,0
"5895",35,126,0,0.8993,99,63,1,5,3,3,6,3,4,"High",-4,4
"5896",35,127,1,0.68873,63,69,5,1,4,1,5,4,4,"High",4,4
"5897",35,128,1,0.83149,76,47,1,1,3,3,6,3,4,"High",0,0
"5898",35,129,0,1.4454,94,58,1,2,3,1,4,1,4,"Low",-1,1
"5899",35,130,1,0.84805,123,94,5,1,4,4,8,4,4,"High",4,4
"5900",35,131,0,1.5021,30,38,3,5,3,1,4,1,4,"Low",-2,2
"5901",35,132,0,1.3736,58,20,2,4,2,1,3,1,4,"Low",-2,2
"5902",35,133,0,1.6417,76,146,1,3,4,2,6,2,4,"High",-2,2
"5903",35,134,0,0.82184,47,18,1,5,4,4,8,4,4,"High",-4,4
"5904",35,135,1,0.75906,146,69,3,1,3,2,5,3,4,"High",2,2
"5905",35,136,0,1.2026,51,129,1,1,2,1,3,1,4,"Low",0,0
"5906",35,137,1,1.0698,59,99,2,1,1,4,5,1,4,"High",1,1
"5907",35,138,0,1.5098,30,59,3,2,4,2,6,2,4,"High",1,1
"5908",35,139,1,2.2854,29,92,2,1,3,4,7,3,4,"High",1,1
"5909",35,140,1,1.0405,117,114,1,1,3,2,5,3,4,"High",0,0
"5910",35,141,0,0.90336,36,29,1,2,3,4,7,4,4,"High",-1,1
"5911",35,142,0,0.92228,83,46,7,7,2,2,4,2,4,"Low",0,0
"5912",35,143,0,1.0876,89,38,1,5,0,2,2,2,4,"Low",-4,4
"5913",35,144,1,0.95639,117,69,1,1,4,3,7,4,4,"High",0,0
"5914",35,145,1,1.2711,116,146,7,3,2,4,6,2,4,"High",4,4
"5915",35,146,0,1.107,87,41,7,8,3,3,6,3,4,"High",-1,1
"5916",35,147,1,0.80524,38,70,5,1,3,3,6,3,4,"High",4,4
"5917",35,148,1,1.3606,114,89,1,1,3,1,4,3,4,"Low",0,0
"5918",35,149,1,0.81326,38,114,5,1,4,4,8,4,4,"High",4,4
"5919",35,150,0,1.5785,116,46,7,7,3,3,6,3,4,"High",0,0
"5920",35,151,1,0.99234,129,69,1,1,2,4,6,2,4,"High",0,0
"5921",35,152,1,1.393,36,51,1,1,4,3,7,4,4,"High",0,0
"5922",35,153,0,1.0543,59,83,2,7,3,3,6,3,4,"High",-5,5
"5923",35,154,1,1.1652,59,20,2,4,4,2,6,4,4,"High",-2,2
"5924",35,155,0,1.1724,109,51,1,1,1,4,5,4,4,"High",0,0
"5925",35,156,0,0.83587,70,58,1,2,4,3,7,3,4,"High",-1,1
"5926",35,157,0,1.6578,118,46,8,7,0,4,4,4,4,"Low",1,1
"5927",35,158,1,0.96327,24,58,1,2,1,4,5,1,4,"High",-1,1
"5928",35,159,0,1.3894,87,20,7,4,4,3,7,3,4,"High",3,3
"5929",35,160,1,1.2056,41,20,8,4,4,4,8,4,4,"High",4,4
"5930",35,161,1,0.96906,118,84,8,8,1,1,2,1,4,"Low",0,0
"5931",35,162,1,1.6131,109,89,1,1,2,2,4,2,4,"Low",0,0
"5932",35,163,1,0.74133,24,129,1,1,2,3,5,2,4,"High",0,0
"5933",35,164,1,1.5792,129,89,1,1,4,3,7,4,4,"High",0,0
"5934",35,165,1,0.63524,24,109,1,1,3,3,6,3,4,"High",0,0
"5935",35,166,1,0.80402,83,118,7,8,4,2,6,4,4,"High",-1,1
"5936",35,167,1,2.7868,118,84,8,8,3,2,5,3,4,"High",0,0
"5937",35,168,0,0.99868,89,24,1,1,4,4,8,4,4,"High",0,0
"5938",35,169,1,0.97084,119,84,8,8,2,3,5,2,4,"High",0,0
"5939",35,170,1,1.4905,118,84,8,8,4,4,8,4,4,"High",0,0
"5940",35,171,1,1.2218,109,2,1,1,4,4,8,4,4,"High",0,0
"5941",35,172,0,1.0532,116,119,7,8,4,3,7,3,4,"High",-1,1
"5942",36,1,1,1.3951,104,116,3,1,0,0,0,0,4,"Low",2,2
"5943",36,2,0,1.5763,30,92,4,2,0,0,0,0,4,"Low",2,2
"5944",36,3,1,1.3119,121,30,1,4,0,1,1,0,4,"Low",-3,3
"5945",36,4,0,1.0701,23,104,2,3,0,1,1,1,4,"Low",-1,1
"5946",36,5,1,1.4034,69,25,2,2,0,0,0,0,4,"Low",0,0
"5947",36,6,1,1.0569,58,23,2,2,0,1,1,0,4,"Low",0,0
"5948",36,7,1,1.1015,38,23,1,2,0,2,2,0,4,"Low",-1,1
"5949",36,8,1,1.7596,112,69,3,2,0,1,1,0,4,"Low",1,1
"5950",36,9,0,2.1597,116,47,1,3,1,0,1,0,4,"Low",-2,2
"5951",36,10,0,3.7249,137,139,1,3,0,0,0,0,4,"Low",-2,2
"5952",36,11,0,1.6982,92,47,2,3,1,1,2,1,4,"Low",-1,1
"5953",36,12,1,1.4869,112,50,3,1,1,0,1,1,4,"Low",2,2
"5954",36,13,0,2.1752,108,101,1,5,0,0,0,0,4,"Low",-4,4
"5955",36,14,1,1.1496,20,95,2,1,0,0,0,0,4,"Low",1,1
"5956",36,15,0,2.0525,145,50,1,1,0,1,1,1,4,"Low",0,0
"5957",36,16,0,1.4366,69,38,2,1,2,1,3,1,4,"Low",1,1
"5958",36,17,0,1.9754,124,104,3,3,0,2,2,2,4,"Low",0,0
"5959",36,18,1,1.0852,104,108,3,1,3,1,4,3,4,"Low",2,2
"5960",36,19,1,1.2166,112,35,3,3,2,0,2,2,4,"Low",0,0
"5961",36,20,1,1.4055,88,101,3,5,0,1,1,0,4,"Low",-2,2
"5962",36,21,0,2.3746,124,50,3,1,1,2,3,2,4,"Low",2,2
"5963",36,22,1,1.6628,21,102,1,1,0,0,0,0,4,"Low",0,0
"5964",36,23,0,3.4002,47,114,3,4,2,0,2,0,4,"Low",-1,1
"5965",36,24,1,2.7304,129,21,2,1,0,1,1,0,4,"Low",1,1
"5966",36,25,0,1.2852,69,87,2,6,3,0,3,0,4,"Low",-4,4
"5967",36,26,0,1.2937,35,41,3,3,1,0,1,0,4,"Low",0,0
"5968",36,27,1,1.437,31,108,3,1,0,2,2,0,4,"Low",2,2
"5969",36,28,1,1.4392,20,69,2,2,1,4,5,1,4,"High",0,0
"5970",36,29,1,1.4525,104,112,3,3,4,3,7,4,4,"High",0,0
"5971",36,30,0,1.4961,68,31,2,3,0,1,1,1,4,"Low",-1,1
"5972",36,31,0,1.4542,36,73,2,5,0,0,0,0,4,"Low",-3,3
"5973",36,32,0,1.7103,95,70,1,2,1,0,1,0,4,"Low",-1,1
"5974",36,33,0,0.9915,62,38,3,1,0,2,2,2,4,"Low",2,2
"5975",36,34,0,4.436,121,129,1,2,1,1,2,1,4,"Low",-1,1
"5976",36,35,1,4.221,38,100,1,2,3,0,3,3,4,"Low",-1,1
"5977",36,36,0,1.2731,92,122,2,4,2,0,2,0,4,"Low",-2,2
"5978",36,37,1,3.4779,68,36,2,2,1,1,2,1,4,"Low",0,0
"5979",36,38,1,5.2937,122,31,4,3,1,2,3,1,4,"Low",1,1
"5980",36,39,0,1.9332,122,87,4,6,2,1,3,1,4,"Low",-2,2
"5981",36,40,0,1.3986,25,141,2,2,1,0,1,0,4,"Low",0,0
"5982",36,41,0,1.8879,36,92,2,2,2,3,5,3,4,"High",0,0
"5983",36,42,1,1.2667,91,23,1,2,0,3,3,0,4,"Low",-1,1
"5984",36,43,1,1.0294,116,36,1,2,2,3,5,2,4,"High",-1,1
"5985",36,44,1,1.8756,68,23,2,2,2,4,6,2,4,"High",0,0
"5986",36,45,0,1.3117,139,114,3,4,1,1,2,1,4,"Low",-1,1
"5987",36,46,0,1.4243,50,114,1,4,3,2,5,2,4,"High",-3,3
"5988",36,47,1,1.0127,47,145,3,1,3,1,4,3,4,"Low",2,2
"5989",36,48,1,1.3104,101,21,5,1,2,2,4,2,4,"Low",4,4
"5990",36,49,1,1.0946,38,102,1,1,4,1,5,4,4,"High",0,0
"5991",36,50,0,1.3659,35,129,3,2,2,2,4,2,4,"Low",1,1
"5992",36,51,0,7.6688,116,58,1,2,3,1,4,1,4,"Low",-1,1
"5993",36,52,0,1.3764,95,41,1,3,2,1,3,1,4,"Low",-2,2
"5994",36,53,0,1.7441,95,31,1,3,3,3,6,3,4,"High",-2,2
"5995",36,54,1,1.8762,47,124,3,3,4,2,6,4,4,"High",0,0
"5996",36,55,1,0.82993,87,95,6,1,2,4,6,2,4,"High",5,5
"5997",36,56,1,1.0663,35,62,3,3,3,1,4,3,4,"Low",0,0
"5998",36,57,1,1.1378,73,58,5,2,1,2,3,1,4,"Low",3,3
"5999",36,58,1,1.141,117,121,3,1,0,2,2,0,4,"Low",2,2
"6000",36,59,1,1.3192,30,102,4,1,2,2,4,2,4,"Low",3,3
"6001",36,60,1,0.99722,41,25,3,2,2,2,4,2,4,"Low",1,1
"6002",36,61,0,1.7586,25,70,2,2,3,1,4,1,4,"Low",0,0
"6003",36,62,0,1.8392,112,141,3,2,4,1,5,1,4,"High",1,1
"6004",36,63,0,1.6967,145,139,1,3,2,2,4,2,4,"Low",-2,2
"6005",36,64,1,1.3947,68,108,2,1,3,3,6,3,4,"High",1,1
"6006",36,65,0,0.97466,21,41,1,3,3,3,6,3,4,"High",-2,2
"6007",36,66,1,0.99826,87,139,6,3,3,3,6,3,4,"High",3,3
"6008",36,67,0,0.95081,121,122,1,4,3,3,6,3,4,"High",-3,3
"6009",36,68,1,3.1255,21,102,1,1,4,3,7,4,4,"High",0,0
"6010",36,69,0,1.2884,58,31,2,3,3,4,7,4,4,"High",-1,1
"6011",36,70,1,1.1541,20,36,2,2,2,4,6,2,4,"High",0,0
"6012",36,71,0,1.1791,35,121,3,1,4,4,8,4,4,"High",2,2
"6013",36,72,1,1.5251,139,91,3,1,4,1,5,4,4,"High",2,2
"6014",36,73,1,1.7145,25,62,2,3,4,2,6,4,4,"High",-1,1
"6015",36,74,0,1.0681,30,101,4,5,3,3,6,3,4,"High",-1,1
"6016",36,75,1,1.6985,124,50,3,1,3,4,7,3,4,"High",2,2
"6017",36,76,0,0.71192,73,122,5,4,2,4,6,4,4,"High",1,1
"6018",36,77,0,0.85134,116,41,1,3,4,4,8,4,4,"High",-2,2
"6019",36,78,1,0.71524,141,73,2,5,2,3,5,2,4,"High",-3,3
"6020",36,79,1,1.1373,114,58,4,2,3,4,7,3,4,"High",2,2
"6021",36,80,0,1.1063,14,137,2,1,0,1,1,1,4,"Low",1,1
"6022",36,81,1,1.4029,124,125,3,6,4,0,4,4,4,"Low",-3,3
"6023",36,82,0,0.76943,145,125,1,6,3,1,4,1,4,"Low",-5,5
"6024",36,83,1,1.017,117,137,3,1,1,2,3,1,4,"Low",2,2
"6025",36,84,1,0.79163,20,101,2,5,3,4,7,3,4,"High",-3,3
"6026",36,85,0,0.97236,68,20,2,2,4,4,8,4,4,"High",0,0
"6027",36,86,1,1.4371,92,145,2,1,4,4,8,4,4,"High",1,1
"6028",36,87,1,1.4275,88,70,3,2,1,2,3,1,4,"Low",1,1
"6029",36,88,1,2.2298,18,70,1,2,0,3,3,0,4,"Low",-1,1
"6030",36,89,0,1.0282,70,87,2,6,4,4,8,4,4,"High",-4,4
"6031",36,90,1,1.2865,100,129,2,2,1,3,4,1,4,"Low",0,0
"6032",36,91,0,1.2664,30,100,4,2,4,2,6,2,4,"High",2,2
"6033",36,92,1,1.2278,117,14,3,2,2,1,3,2,4,"Low",1,1
"6034",36,93,0,2.01,100,114,2,4,3,4,7,4,4,"High",-2,2
"6035",36,94,1,1.3706,137,125,1,6,3,2,5,3,4,"High",-5,5
"6036",36,95,0,2.004,125,117,6,3,3,3,6,3,4,"High",3,3
"6037",36,96,0,0.70863,91,141,1,2,2,3,5,3,4,"High",-1,1
"6038",36,97,0,1.2088,102,129,1,2,4,4,8,4,4,"High",-1,1
"6039",36,98,1,0.6009,141,14,2,2,4,2,6,4,4,"High",0,0
"6040",36,99,1,2.2269,108,14,1,2,4,3,7,4,4,"High",-1,1
"6041",36,100,0,2.1608,117,85,3,6,4,0,4,0,4,"Low",-3,3
"6042",36,101,0,1.2682,125,14,6,2,4,4,8,4,4,"High",4,4
"6043",36,102,1,0.96632,137,100,1,2,4,4,8,4,4,"High",-1,1
"6044",36,103,1,1.0998,18,73,1,5,1,4,5,1,4,"High",-4,4
"6045",36,104,0,1.5117,18,88,1,3,2,2,4,2,4,"Low",-2,2
"6046",36,105,0,0.99508,91,85,1,6,3,1,4,1,4,"Low",-5,5
"6047",36,106,0,1.9425,62,91,3,1,3,4,7,4,4,"High",2,2
"6048",36,107,1,1.359,88,62,3,3,3,4,7,3,4,"High",0,0
"6049",36,108,1,0.64106,88,18,3,1,4,3,7,4,4,"High",2,2
"6050",36,109,0,1.078,18,85,1,6,4,2,6,2,4,"High",-5,5
"6051",37,1,0,1.0193,47,6,2,1,0,0,0,0,4,"Low",1,1
"6052",37,2,1,1.1298,70,147,2,2,0,0,0,0,4,"Low",0,0
"6053",37,3,1,1.2748,18,63,8,8,0,0,0,0,4,"Low",0,0
"6054",37,4,0,1.2002,117,56,3,2,0,0,0,0,4,"Low",1,1
"6055",37,5,1,4.3185,10,73,1,6,0,0,0,0,4,"Low",-5,5
"6056",37,6,1,0.89636,71,129,2,1,0,0,0,0,4,"Low",1,1
"6057",37,7,0,0.80878,92,141,2,3,0,0,0,0,4,"Low",-1,1
"6058",37,8,0,0.56687,53,119,3,8,0,0,0,0,4,"Low",-5,5
"6059",37,9,0,1.0089,43,126,2,3,0,0,0,0,4,"Low",-1,1
"6060",37,10,1,1.5843,125,7,2,3,0,0,0,0,4,"Low",-1,1
"6061",37,11,1,1.0383,5,56,1,2,0,1,1,0,4,"Low",-1,1
"6062",37,12,0,1.259,20,105,2,6,0,0,0,0,4,"Low",-4,4
"6063",37,13,1,2.8143,12,147,4,2,0,1,1,0,4,"Low",2,2
"6064",37,14,0,1.671,47,104,2,3,1,0,1,0,4,"Low",-1,1
"6065",37,15,1,1.2038,87,27,3,2,0,0,0,0,4,"Low",1,1
"6066",37,16,0,1.4646,7,113,3,2,1,0,1,0,4,"Low",1,1
"6067",37,17,1,0.80253,110,23,2,1,0,0,0,0,4,"Low",1,1
"6068",37,18,0,0.65366,25,105,1,6,0,1,1,1,4,"Low",-5,5
"6069",37,19,0,0.87135,39,73,1,6,0,1,1,1,4,"Low",-5,5
"6070",37,20,0,1.474,104,86,3,3,1,0,1,0,4,"Low",0,0
"6071",37,21,1,0.94931,104,53,3,3,2,1,3,2,4,"Low",0,0
"6072",37,22,0,1.2781,73,147,6,2,2,2,4,2,4,"Low",4,4
"6073",37,23,0,1.282,69,126,4,3,0,1,1,1,4,"Low",1,1
"6074",37,24,0,1.376,110,42,2,2,1,0,1,0,4,"Low",0,0
"6075",37,25,1,0.95459,104,126,3,3,3,2,5,3,4,"High",0,0
"6076",37,26,1,1.5895,127,47,2,2,0,2,2,0,4,"Low",0,0
"6077",37,27,1,1.1268,127,29,2,1,1,0,1,1,4,"Low",1,1
"6078",37,28,1,1.4987,126,69,3,4,3,1,4,3,4,"Low",-1,1
"6079",37,29,0,1.2069,69,32,4,5,2,0,2,0,4,"Low",-1,1
"6080",37,30,1,0.84142,105,20,6,2,2,1,3,2,4,"Low",4,4
"6081",37,31,1,1.459,113,29,2,1,1,1,2,1,4,"Low",1,1
"6082",37,32,1,1.5029,131,47,5,2,0,3,3,0,4,"Low",3,3
"6083",37,33,1,1.0763,12,7,4,3,1,2,3,1,4,"Low",1,1
"6084",37,34,1,1.1003,71,20,2,2,1,2,3,1,4,"Low",0,0
"6085",37,35,1,0.98307,15,87,4,3,0,1,1,0,4,"Low",1,1
"6086",37,36,0,1.2285,10,41,1,3,1,0,1,0,4,"Low",-2,2
"6087",37,37,1,1.7145,133,87,1,3,0,2,2,0,4,"Low",-2,2
"6088",37,38,0,1.3674,125,42,2,2,1,1,2,1,4,"Low",0,0
"6089",37,39,1,0.64694,105,43,6,2,3,1,4,3,4,"Low",4,4
"6090",37,40,1,0.63321,146,70,2,2,0,1,1,0,4,"Low",0,0
"6091",37,41,1,1.6494,127,56,2,2,2,2,4,2,4,"Low",0,0
"6092",37,42,0,0.97341,7,133,3,1,3,1,4,1,4,"Low",2,2
"6093",37,43,0,1.0879,45,70,3,2,0,2,2,2,4,"Low",1,1
"6094",37,44,1,1.2915,110,122,2,4,2,0,2,2,4,"Low",-2,2
"6095",37,45,1,1.3622,125,25,2,1,2,1,3,2,4,"Low",1,1
"6096",37,46,0,1.5307,88,20,1,2,0,3,3,3,4,"Low",-1,1
"6097",37,47,1,0.7567,25,129,1,1,2,1,3,2,4,"Low",0,0
"6098",37,48,1,1.2883,87,46,3,2,3,0,3,3,4,"Low",1,1
"6099",37,49,1,0.55102,43,12,2,4,2,2,4,2,4,"Low",-2,2
"6100",37,50,0,0.59609,40,146,1,2,0,1,1,1,4,"Low",-1,1
"6101",37,51,1,0.65233,87,68,3,6,4,0,4,4,4,"Low",-3,3
"6102",37,52,0,0.46422,104,69,3,4,4,3,7,3,4,"High",-1,1
"6103",37,53,0,1.1205,127,32,2,5,3,1,4,1,4,"Low",-3,3
"6104",37,54,1,0.59503,69,122,4,4,4,1,5,4,4,"High",0,0
"6105",37,55,0,0.90567,45,127,3,2,1,4,5,4,4,"High",1,1
"6106",37,56,0,1.1797,102,20,5,2,0,4,4,4,4,"Low",3,3
"6107",37,57,0,1.2044,122,139,4,7,2,0,2,0,4,"Low",-3,3
"6108",37,58,1,1.069,126,88,3,1,4,1,5,4,4,"High",2,2
"6109",37,59,0,0.99145,56,146,2,2,3,2,5,2,4,"High",0,0
"6110",37,60,0,0.97662,56,44,2,2,4,0,4,0,4,"Low",0,0
"6111",37,61,0,1.2521,122,15,4,4,3,1,4,1,4,"Low",0,0
"6112",37,62,1,1.2861,42,29,2,1,2,2,4,2,4,"Low",1,1
"6113",37,63,0,1.4562,78,133,1,1,0,2,2,2,4,"Low",0,0
"6114",37,64,1,1.094,43,102,2,5,3,1,4,3,4,"Low",-3,3
"6115",37,65,0,1.4349,6,40,1,1,1,1,2,1,4,"Low",0,0
"6116",37,66,1,0.62434,5,73,1,6,1,3,4,1,4,"Low",-5,5
"6117",37,67,0,1.1041,32,143,5,9,2,0,2,0,4,"Low",-4,4
"6118",37,68,0,1.1732,39,29,1,1,1,3,4,3,4,"Low",0,0
"6119",37,69,1,0.83547,12,117,4,3,3,1,4,3,4,"Low",1,1
"6120",37,70,0,0.92098,41,146,3,2,1,3,4,3,4,"Low",1,1
"6121",37,71,1,0.54985,41,71,3,2,2,2,4,2,4,"Low",1,1
"6122",37,72,0,0.82313,102,120,5,1,2,0,2,0,4,"Low",4,4
"6123",37,73,1,0.59366,5,39,1,1,2,2,4,2,4,"Low",0,0
"6124",37,74,0,1.0592,29,68,1,6,4,1,5,1,4,"High",-5,5
"6125",37,75,0,1.3278,3,32,5,5,0,3,3,3,4,"Low",0,0
"6126",37,76,0,0.90433,44,68,2,6,1,2,3,2,4,"Low",-4,4
"6127",37,77,0,1.7646,122,102,4,5,4,3,7,3,4,"High",-1,1
"6128",37,78,1,2.0691,147,71,2,2,3,3,6,3,4,"High",0,0
"6129",37,79,1,0.64581,139,86,7,3,1,1,2,1,4,"Low",4,4
"6130",37,80,0,1.2894,133,42,1,2,3,3,6,3,4,"High",-1,1
"6131",37,81,0,1.176,129,113,1,2,2,2,4,2,4,"Low",-1,1
"6132",37,82,1,0.97677,119,143,8,9,1,1,2,1,4,"Low",-1,1
"6133",37,83,0,0.93331,86,119,3,8,2,2,4,2,4,"Low",-5,5
"6134",37,84,1,1.8282,73,40,6,1,4,2,6,4,4,"High",5,5
"6135",37,85,1,0.94984,15,43,4,2,2,4,6,2,4,"High",2,2
"6136",37,86,0,1.2376,41,115,3,4,3,0,3,0,4,"Low",-1,1
"6137",37,87,0,1.2743,25,7,1,3,3,4,7,4,4,"High",-2,2
"6138",37,88,1,0.53712,70,110,2,2,3,3,6,3,4,"High",0,0
"6139",37,89,1,0.90509,32,102,5,5,4,4,8,4,4,"High",0,0
"6140",37,90,0,1.7718,115,5,4,1,1,3,4,3,4,"Low",3,3
"6141",37,91,0,0.72338,115,119,4,8,2,3,5,3,4,"High",-4,4
"6142",37,92,1,0.63609,139,71,7,2,2,4,6,2,4,"High",5,5
"6143",37,93,1,1.2244,12,57,4,3,4,0,4,4,4,"Low",1,1
"6144",37,94,1,2.9185,78,6,1,1,1,2,3,1,4,"Low",0,0
"6145",37,95,0,0.56214,45,15,3,4,2,3,5,3,4,"High",-1,1
"6146",37,96,1,0.55339,41,10,3,1,4,2,6,4,4,"High",2,2
"6147",37,97,1,1.0601,74,117,2,3,0,2,2,0,4,"Low",-1,1
"6148",37,98,1,1.3559,125,46,2,2,3,1,4,3,4,"Low",0,0
"6149",37,99,1,1.3202,3,105,5,6,1,4,5,1,4,"High",-1,1
"6150",37,100,0,0.86631,46,44,2,2,2,2,4,2,4,"Low",0,0
"6151",37,101,0,1.475,68,63,6,8,3,1,4,1,4,"Low",-2,2
"6152",37,102,0,0.701,39,40,1,1,3,3,6,3,4,"High",0,0
"6153",37,103,0,0.67083,10,27,1,2,3,1,4,1,4,"Low",-1,1
"6154",37,104,1,0.6263,88,120,1,1,2,1,3,2,4,"Low",0,0
"6155",37,105,0,1.0331,25,53,1,3,4,2,6,2,4,"High",-2,2
"6156",37,106,1,0.62643,139,92,7,2,3,1,4,3,4,"Low",5,5
"6157",37,107,0,0.80728,120,110,1,2,2,4,6,4,4,"High",-1,1
"6158",37,108,1,0.57857,63,72,8,9,2,0,2,2,4,"Low",-1,1
"6159",37,109,0,1.0519,117,92,3,2,3,2,5,2,4,"High",1,1
"6160",37,110,0,1.1405,40,10,1,1,4,4,8,4,4,"High",0,0
"6161",37,111,1,0.87469,143,115,9,4,2,3,5,2,4,"High",5,5
"6162",37,112,1,0.72816,106,76,9,4,0,0,0,0,4,"Low",5,5
"6163",37,113,0,0.83006,45,42,3,2,3,4,7,4,4,"High",1,1
"6164",37,114,1,0.86273,70,78,2,1,4,2,6,4,4,"High",1,1
"6165",37,115,1,1.1027,5,88,1,1,4,3,7,4,4,"High",0,0
"6166",37,116,1,1.176,6,39,1,1,3,4,7,3,4,"High",0,0
"6167",37,117,1,1.5737,15,53,4,3,4,3,7,4,4,"High",1,1
"6168",37,118,1,0.81886,125,23,2,1,4,1,5,4,4,"High",1,1
"6169",37,119,1,1.263,68,46,6,2,4,3,7,4,4,"High",4,4
"6170",37,120,0,1.001,45,86,3,3,4,3,7,3,4,"High",0,0
"6171",37,121,1,1.1618,106,76,9,4,1,1,2,1,4,"Low",5,5
"6172",37,122,1,0.58296,139,79,7,3,4,0,4,4,4,"Low",4,4
"6173",37,123,0,1.078,129,86,1,3,3,4,7,4,4,"High",-2,2
"6174",37,124,0,1.4957,117,146,3,2,4,4,8,4,4,"High",1,1
"6175",37,125,0,1.0368,6,53,1,3,4,4,8,4,4,"High",-2,2
"6176",37,126,1,0.51396,119,107,8,8,4,0,4,4,4,"Low",0,0
"6177",37,127,0,1.3224,107,18,8,8,1,1,2,1,4,"Low",0,0
"6178",37,128,1,0.87776,141,113,3,2,1,3,4,1,4,"Low",1,1
"6179",37,129,1,0.844,88,46,1,2,4,4,8,4,4,"High",-1,1
"6180",37,130,1,0.85968,18,3,8,5,2,2,4,2,4,"Low",3,3
"6181",37,131,0,1.0593,76,107,4,8,2,2,4,2,4,"Low",-4,4
"6182",37,132,0,2.9565,79,27,3,2,1,2,3,2,4,"Low",1,1
"6183",37,133,1,1.1894,107,3,8,5,3,3,6,3,4,"High",3,3
"6184",37,134,1,0.6489,106,72,9,9,2,1,3,2,4,"Low",0,0
"6185",37,135,0,1.401,74,44,2,2,1,3,4,3,4,"Low",0,0
"6186",37,136,1,1.7516,131,78,5,1,1,3,4,1,4,"Low",4,4
"6187",37,137,0,1.7241,129,74,1,2,4,2,6,2,4,"High",-1,1
"6188",37,138,0,1.044,131,107,5,8,2,4,6,4,4,"High",-3,3
"6189",37,139,1,0.98046,113,137,2,1,4,0,4,4,4,"Low",1,1
"6190",37,140,0,0.61895,133,141,1,3,4,2,6,2,4,"High",-2,2
"6191",37,141,1,0.64251,44,23,2,1,4,2,6,4,4,"High",1,1
"6192",37,142,1,0.7132,143,72,9,9,3,2,5,3,4,"High",0,0
"6193",37,143,0,0.6017,120,27,1,2,3,3,6,3,4,"High",-1,1
"6194",37,144,1,0.61643,120,23,1,1,4,3,7,4,4,"High",0,0
"6195",37,145,0,3.1011,115,72,4,9,4,3,7,3,4,"High",-5,5
"6196",37,146,1,1.3899,92,74,2,2,3,3,6,3,4,"High",0,0
"6197",37,147,1,1.4691,131,76,5,4,3,3,6,3,4,"High",1,1
"6198",37,148,1,0.94134,147,74,2,2,4,4,8,4,4,"High",0,0
"6199",37,149,0,1.0887,79,57,3,3,2,1,3,1,4,"Low",0,0
"6200",37,150,0,0.8232,23,131,1,5,4,4,8,4,4,"High",-4,4
"6201",37,151,1,0.71085,106,143,9,9,3,4,7,3,4,"High",0,0
"6202",37,152,1,0.5454,106,3,9,5,4,4,8,4,4,"High",4,4
"6203",37,153,0,1.0181,78,57,1,3,4,2,6,2,4,"High",-2,2
"6204",37,154,0,1.3054,76,27,4,2,4,4,8,4,4,"High",2,2
"6205",37,155,1,2.8714,72,63,9,8,4,3,7,4,4,"High",1,1
"6206",37,156,0,1.3437,47,79,2,3,4,3,7,3,4,"High",-1,1
"6207",37,157,1,1.089,18,4,8,4,3,0,3,3,4,"Low",4,4
"6208",37,158,1,0.85918,18,4,8,4,4,1,5,4,4,"High",4,4
"6209",37,159,1,2.3278,57,141,3,3,3,3,6,3,4,"High",0,0
"6210",37,160,0,1.4671,4,137,4,1,2,1,3,1,4,"Low",3,3
"6211",37,161,0,0.80433,4,79,4,3,3,4,7,4,4,"High",1,1
"6212",37,162,1,1.1266,141,137,3,1,4,2,6,4,4,"High",2,2
"6213",37,163,0,1.4758,137,57,1,3,3,4,7,4,4,"High",-2,2
"6214",37,164,1,1.046,63,4,8,4,4,4,8,4,4,"High",4,4
"6215",37,165,1,0.94529,92,137,2,1,4,4,8,4,4,"High",1,1
"6216",38,1,1,2.8912,66,119,8,5,0,0,0,0,2,"Low",3,3
"6217",38,2,1,1.0775,107,81,7,2,0,0,0,0,2,"Low",5,5
"6218",38,3,0,1.5449,5,138,8,6,0,0,0,0,2,"Low",2,2
"6219",38,4,1,1.1457,126,13,5,3,0,0,0,0,2,"Low",2,2
"6220",38,5,1,1.2424,86,129,8,9,0,0,0,0,2,"Low",-1,1
"6221",38,6,0,1.943,81,49,2,3,1,0,1,0,2,"Low",-1,1
"6222",38,7,1,1.0479,88,84,5,8,0,0,0,0,2,"Low",-3,3
"6223",38,8,0,1.27,63,126,5,5,0,1,1,1,2,"Low",0,0
"6224",38,9,1,1.0962,18,21,8,3,0,0,0,0,2,"Low",5,5
"6225",38,10,1,1.3954,108,107,8,7,0,1,1,0,2,"Low",1,1
"6226",38,11,0,0.96076,13,107,3,7,1,2,3,2,2,"High",-4,4
"6227",38,12,0,0.77672,81,2,2,5,2,0,2,0,2,"Low",-3,3
"6228",38,13,1,0.91751,25,96,7,6,0,0,0,0,2,"Low",1,1
"6229",38,14,1,0.95852,83,1,8,5,0,0,0,0,2,"Low",3,3
"6230",38,15,1,1.0886,96,147,6,4,1,0,1,1,2,"Low",2,2
"6231",38,16,0,0.67686,53,104,6,10,0,0,0,0,2,"Low",-4,4
"6232",38,17,1,0.82287,41,141,6,5,0,0,0,0,2,"Low",1,1
"6233",38,18,1,1.2224,55,13,3,3,0,2,2,0,2,"Low",0,0
"6234",38,19,0,1.7142,69,111,6,4,0,0,0,0,2,"Low",2,2
"6235",38,20,1,0.75908,41,137,6,3,1,0,1,1,2,"Low",3,3
"6236",38,21,1,1.7975,14,144,4,5,0,0,0,0,2,"Low",-1,1
"6237",38,22,1,0.633,104,30,10,7,1,0,1,1,2,"Low",3,3
"6238",38,23,0,0.6091,31,27,3,6,0,0,0,0,2,"Low",-3,3
"6239",38,24,0,0.96793,14,103,4,4,1,0,1,0,2,"Low",0,0
"6240",38,25,0,1.1871,88,14,5,4,1,2,3,2,2,"High",1,1
"6241",38,26,0,0.83389,100,121,5,9,0,0,0,0,2,"Low",-4,4
"6242",38,27,1,1.0066,82,76,6,1,0,0,0,0,2,"Low",5,5
"6243",38,28,1,1.3985,77,110,4,4,0,0,0,0,2,"Low",0,0
"6244",38,29,0,0.92334,20,67,6,5,0,0,0,0,2,"Low",1,1
"6245",38,30,0,1.2141,49,87,3,4,1,0,1,0,2,"Low",-1,1
"6246",38,31,0,0.80999,13,134,3,5,3,0,3,0,2,"High",-2,2
"6247",38,32,0,0.95195,119,5,5,8,1,1,2,1,2,"Low",-3,3
"6248",38,33,0,1.616,72,87,4,4,0,1,1,1,2,"Low",0,0
"6249",38,34,0,1.2742,100,103,5,4,1,1,2,1,2,"Low",1,1
"6250",38,35,1,1.1882,46,115,10,9,0,0,0,0,2,"Low",1,1
"6251",38,36,0,0.66022,113,3,4,7,0,0,0,0,2,"Low",-3,3
"6252",38,37,1,0.85632,58,90,7,4,0,0,0,0,2,"Low",3,3
"6253",38,38,1,1.7163,65,102,6,5,0,0,0,0,2,"Low",1,1
"6254",38,39,1,1.4378,25,74,7,4,1,0,1,1,2,"Low",3,3
"6255",38,40,1,2.1358,68,81,6,2,0,3,3,0,2,"High",4,4
"6256",38,41,0,0.92833,124,77,4,4,0,1,1,1,2,"Low",0,0
"6257",38,42,1,0.92186,141,98,5,3,1,0,1,1,2,"Low",2,2
"6258",38,43,1,1.3473,34,68,7,6,0,1,1,0,2,"Low",1,1
"6259",38,44,1,1.1552,34,1,7,5,1,1,2,1,2,"Low",2,2
"6260",38,45,1,1.1551,143,68,6,6,0,2,2,0,2,"Low",0,0
"6261",38,46,0,1.0788,20,146,6,3,1,0,1,0,2,"Low",3,3
"6262",38,47,0,0.82079,123,110,4,4,0,1,1,1,2,"Low",0,0
"6263",38,48,1,0.88126,18,14,8,4,1,3,4,1,2,"High",4,4
"6264",38,49,1,1.2439,62,147,7,4,0,1,1,0,2,"Low",3,3
"6265",38,50,1,0.9043,47,27,3,6,0,1,1,0,2,"Low",-3,3
"6266",38,51,1,0.89794,16,52,6,8,0,0,0,0,2,"Low",-2,2
"6267",38,52,1,0.73218,118,66,8,8,0,1,1,0,2,"Low",0,0
"6268",38,53,0,0.6369,136,42,3,8,0,0,0,0,2,"Low",-5,5
"6269",38,54,0,1.1696,75,62,2,7,0,1,1,1,2,"Low",-5,5
"6270",38,55,1,0.6083,140,20,5,6,0,2,2,0,2,"Low",-1,1
"6271",38,56,0,0.75575,134,94,5,6,1,0,1,0,2,"Low",-1,1
"6272",38,57,1,1.1152,21,83,3,8,1,1,2,1,2,"Low",-5,5
"6273",38,58,0,0.68105,120,133,1,5,0,0,0,0,2,"Low",-4,4
"6274",38,59,1,1.1158,16,24,6,3,1,0,1,1,2,"Low",3,3
"6275",38,60,0,1.245,74,18,4,8,1,2,3,2,2,"High",-4,4
"6276",38,61,1,0.91966,85,27,10,6,0,2,2,0,2,"Low",4,4
"6277",38,62,0,1.354,147,83,4,8,2,2,4,2,2,"High",-4,4
"6278",38,63,0,0.64145,1,87,5,4,2,2,4,2,2,"High",1,1
"6279",38,64,1,0.74193,18,38,8,4,3,0,3,3,2,"High",4,4
"6280",38,65,1,1.0628,122,125,7,5,0,0,0,0,2,"Low",2,2
"6281",38,66,0,0.48848,147,88,4,5,3,2,5,2,2,"High",-1,1
"6282",38,67,0,1.9234,65,52,6,8,1,1,2,1,2,"Low",-2,2
"6283",38,68,1,0.93277,21,49,3,3,2,2,4,2,2,"High",0,0
"6284",38,69,1,1.0376,48,90,8,4,0,1,1,0,2,"Low",4,4
"6285",38,70,0,0.97678,87,138,4,6,3,1,4,1,2,"High",-2,2
"6286",38,71,0,0.66416,128,87,2,4,0,4,4,4,2,"High",-2,2
"6287",38,72,1,0.84357,105,50,4,6,0,0,0,0,2,"Low",-2,2
"6288",38,73,0,0.68,67,14,5,4,1,4,5,4,2,"High",1,1
"6289",38,74,0,0.70836,65,70,6,2,2,0,2,0,2,"Low",4,4
"6290",38,75,1,0.7922,105,35,4,4,1,0,1,1,2,"Low",0,0
"6291",38,76,0,1.1588,142,144,2,5,0,1,1,1,2,"Low",-3,3
"6292",38,77,0,1.0957,31,48,3,8,1,1,2,1,2,"Low",-5,5
"6293",38,78,0,0.79428,53,86,6,8,1,1,2,1,2,"Low",-2,2
"6294",38,79,1,1.0593,103,130,4,2,2,0,2,2,2,"Low",2,2
"6295",38,80,0,0.93038,72,100,4,5,1,2,3,2,2,"High",-1,1
"6296",38,81,1,0.74699,114,120,4,1,0,1,1,0,2,"Low",3,3
"6297",38,82,1,0.69666,3,110,7,4,1,2,3,1,2,"High",3,3
"6298",38,83,0,0.86114,26,128,4,2,0,1,1,1,2,"Low",2,2
"6299",38,84,1,0.84383,140,76,5,1,1,1,2,1,2,"Low",4,4
"6300",38,85,1,0.80705,99,31,5,3,0,2,2,0,2,"Low",2,2
"6301",38,86,1,0.65981,27,141,6,5,3,2,5,3,2,"High",1,1
"6302",38,87,1,1.1172,9,65,6,6,0,3,3,0,2,"High",0,0
"6303",38,88,1,1.5188,32,143,5,6,0,1,1,0,2,"Low",-1,1
"6304",38,89,1,0.83209,86,32,8,5,2,1,3,2,2,"High",3,3
"6305",38,90,1,0.78065,96,131,6,2,2,0,2,2,2,"Low",4,4
"6306",38,91,0,1.4349,70,94,2,6,1,1,2,1,2,"Low",-4,4
"6307",38,92,1,1.7273,69,63,6,5,1,1,2,1,2,"Low",1,1
"6308",38,93,0,1.3532,96,143,6,6,3,2,5,2,2,"High",0,0
"6309",38,94,1,1.0672,34,61,7,2,2,0,2,2,2,"Low",5,5
"6310",38,95,0,0.98009,137,43,3,7,1,0,1,0,2,"Low",-4,4
"6311",38,96,1,1.6748,93,35,4,4,0,1,1,0,2,"Low",0,0
"6312",38,97,0,1.0698,132,144,5,5,0,2,2,2,2,"Low",0,0
"6313",38,98,0,1.0297,129,41,9,6,1,2,3,2,2,"High",3,3
"6314",38,99,1,1.0071,146,47,3,3,1,1,2,1,2,"Low",0,0
"6315",38,100,1,0.90973,5,24,8,3,2,1,3,2,2,"High",5,5
"6316",38,101,0,0.80569,94,146,6,3,2,2,4,2,2,"High",3,3
"6317",38,102,0,0.62102,111,68,4,6,1,3,4,3,2,"High",-2,2
"6318",38,103,1,0.59479,27,97,6,7,4,0,4,4,2,"High",-1,1
"6319",38,104,0,1.0183,26,111,4,4,1,2,3,2,2,"High",0,0
"6320",38,105,1,0.97459,114,8,4,6,1,0,1,1,2,"Low",-2,2
"6321",38,106,0,0.7317,124,101,4,5,1,0,1,0,2,"Low",-1,1
"6322",38,107,1,2.6928,105,66,4,8,2,2,4,2,2,"High",-4,4
"6323",38,108,1,0.75365,68,147,6,4,4,4,8,4,2,"High",2,2
"6324",38,109,0,1.1688,47,20,3,6,2,3,5,3,2,"High",-3,3
"6325",38,110,0,0.77373,16,42,6,8,2,1,3,1,2,"High",-2,2
"6326",38,111,0,0.79838,39,69,6,6,0,2,2,2,2,"Low",0,0
"6327",38,112,1,1.1975,34,43,7,7,3,1,4,3,2,"High",0,0
"6328",38,113,0,0.71841,102,105,5,4,1,3,4,3,2,"High",1,1
"6329",38,114,0,1.325,2,121,5,9,1,1,2,1,2,"Low",-4,4
"6330",38,115,0,0.80658,93,50,4,6,1,1,2,1,2,"Low",-2,2
"6331",38,116,1,0.93224,132,130,5,2,1,1,2,1,2,"Low",3,3
"6332",38,117,1,0.82631,32,107,5,7,2,3,5,2,2,"High",-2,2
"6333",38,118,1,0.7783,47,72,3,4,3,2,5,3,2,"High",-1,1
"6334",38,119,0,2.257,113,12,4,2,1,0,1,0,2,"Low",2,2
"6335",38,120,1,0.7751,47,34,3,7,4,4,8,4,2,"High",-4,4
"6336",38,121,0,0.59872,132,98,5,3,2,1,3,1,2,"High",2,2
"6337",38,122,0,0.77048,43,139,7,10,2,0,2,0,2,"Low",-3,3
"6338",38,123,0,1.0747,11,123,2,4,0,1,1,1,2,"Low",-2,2
"6339",38,124,0,0.56526,32,55,5,3,3,1,4,1,2,"High",2,2
"6340",38,125,1,2.6226,129,110,9,4,2,3,5,2,2,"High",5,5
"6341",38,126,0,0.97896,125,124,5,4,1,2,3,2,2,"High",1,1
"6342",38,127,1,0.97003,11,75,2,2,1,1,2,1,2,"Low",0,0
"6343",38,128,0,0.62535,20,115,6,9,4,1,5,1,2,"High",-3,3
"6344",38,129,1,1.0787,30,124,7,4,1,3,4,1,2,"High",3,3
"6345",38,130,0,0.64212,81,41,2,6,4,3,7,3,2,"High",-4,4
"6346",38,131,0,1.1827,93,112,4,5,2,0,2,0,2,"Low",-1,1
"6347",38,132,1,0.76589,144,139,5,10,3,1,4,3,2,"High",-5,5
"6348",38,133,0,1.0438,136,112,3,5,1,1,2,1,2,"Low",-2,2
"6349",38,134,0,0.95223,18,122,8,7,4,1,5,1,2,"High",1,1
"6350",38,135,1,0.87024,102,12,5,2,2,1,3,2,2,"High",3,3
"6351",38,136,0,0.60989,56,36,6,3,0,0,0,0,2,"Low",3,3
"6352",38,137,0,1.3171,13,127,3,1,4,0,4,0,2,"High",2,2
"6353",38,138,1,0.92446,139,125,10,5,2,2,4,2,2,"High",5,5
"6354",38,139,1,0.75043,43,49,7,3,3,3,6,3,2,"High",4,4
"6355",38,140,0,1.2945,78,44,5,6,0,0,0,0,2,"Low",-1,1
"6356",38,141,1,0.60108,118,108,8,8,1,1,2,1,2,"Low",0,0
"6357",38,142,0,0.7266,113,72,4,4,2,3,5,3,2,"High",0,0
"6358",38,143,0,0.70478,39,1,6,5,1,3,4,3,2,"High",1,1
"6359",38,144,0,1.0107,1,35,5,4,4,2,6,2,2,"High",1,1
"6360",38,145,1,0.98473,141,144,5,5,3,4,7,3,2,"High",0,0
"6361",38,146,0,0.63951,75,132,2,5,2,3,5,3,2,"High",-3,3
"6362",38,147,1,0.80388,78,25,5,7,1,2,3,1,2,"High",-2,2
"6363",38,148,0,0.62614,11,105,2,4,2,4,6,4,2,"High",-2,2
"6364",38,149,1,0.90357,41,33,6,3,4,0,4,4,2,"High",3,3
"6365",38,150,1,1.0574,99,137,5,3,1,2,3,1,2,"High",2,2
"6366",38,151,1,1.1092,43,38,7,4,4,1,5,4,2,"High",3,3
"6367",38,152,0,0.75869,45,10,6,6,0,0,0,0,2,"Low",0,0
"6368",38,153,1,0.647,77,48,4,8,2,2,4,2,2,"High",-4,4
"6369",38,154,1,0.6805,112,84,5,8,2,1,3,2,2,"High",-3,3
"6370",38,155,1,0.84287,100,80,5,3,3,0,3,3,2,"High",2,2
"6371",38,156,1,0.93555,49,84,3,8,4,2,6,4,2,"High",-5,5
"6372",38,157,1,0.77752,3,6,7,9,2,0,2,2,2,"Low",-2,2
"6373",38,158,1,2.6557,131,146,2,3,1,3,4,1,2,"High",-1,1
"6374",38,159,0,1.1556,145,115,10,9,0,2,2,2,2,"Low",1,1
"6375",38,160,0,0.73058,53,114,6,4,2,2,4,2,2,"High",2,2
"6376",38,161,1,0.53905,104,53,10,6,2,3,5,2,2,"High",4,4
"6377",38,162,0,0.81997,123,98,4,3,2,2,4,2,2,"High",1,1
"6378",38,163,0,0.75769,12,88,2,5,2,3,5,3,2,"High",-3,3
"6379",38,164,1,1.3453,88,89,5,4,4,0,4,4,2,"High",1,1
"6380",38,165,0,1.1893,126,19,5,9,2,0,2,0,2,"Low",-4,4
"6381",38,166,1,0.98008,67,2,5,5,2,2,4,2,2,"High",0,0
"6382",38,167,1,0.98668,114,84,4,8,3,3,6,3,2,"High",-4,4
"6383",38,168,1,0.73731,29,98,7,3,0,3,3,0,2,"High",4,4
"6384",38,169,1,0.93882,126,124,5,4,3,4,7,3,2,"High",1,1
"6385",38,170,0,0.67535,12,32,2,5,3,4,7,4,2,"High",-3,3
"6386",38,171,1,1.1855,113,62,4,7,3,2,5,3,2,"High",-3,3
"6387",38,172,0,1.833,136,143,3,6,2,3,5,3,2,"High",-3,3
"6388",38,173,1,1.1082,7,119,9,5,0,2,2,0,2,"Low",4,4
"6389",38,174,0,0.80668,136,8,3,6,3,1,4,1,2,"High",-3,3
"6390",38,175,0,1.1176,137,72,3,4,3,4,7,4,2,"High",-1,1
"6391",38,176,0,0.72247,99,7,5,9,2,1,3,1,2,"High",-4,4
"6392",38,177,0,1.1683,53,30,6,7,4,2,6,2,2,"High",-1,1
"6393",38,178,1,0.78042,120,128,1,2,2,2,4,2,2,"High",-1,1
"6394",38,179,1,1.115,62,91,7,2,3,0,3,3,2,"High",5,5
"6395",38,180,1,1.0684,114,127,4,1,4,1,5,4,2,"High",3,3
"6396",38,181,1,0.76784,126,21,5,3,4,3,7,4,2,"High",2,2
"6397",38,182,0,0.54333,112,139,5,10,3,3,6,3,2,"High",-5,5
"6398",38,183,0,0.48787,39,139,6,10,2,4,6,4,2,"High",-4,4
"6399",38,184,0,0.57331,61,98,2,3,1,4,5,4,2,"High",-1,1
"6400",38,185,0,0.80117,74,89,4,4,2,1,3,1,2,"High",0,0
"6401",38,186,0,1.0802,80,26,3,4,1,2,3,2,2,"High",-1,1
"6402",38,187,1,0.87478,82,9,6,6,1,1,2,1,2,"Low",0,0
"6403",38,188,0,0.7655,10,42,6,8,1,2,3,2,2,"High",-2,2
"6404",38,189,0,0.94097,75,33,2,3,3,1,4,1,2,"High",-1,1
"6405",38,190,1,0.85345,101,106,5,3,1,0,1,1,2,"Low",2,2
"6406",38,191,0,0.60957,128,106,2,3,3,1,4,1,2,"High",-1,1
"6407",38,192,1,0.98353,12,135,2,4,4,0,4,4,2,"High",-2,2
"6408",38,193,1,1.0029,38,110,4,4,2,4,6,2,2,"High",0,0
"6409",38,194,0,0.729,69,38,6,4,3,3,6,3,2,"High",2,2
"6410",38,195,0,0.76212,111,48,4,8,3,3,6,3,2,"High",-4,4
"6411",38,196,0,1.1203,76,106,1,3,2,2,4,2,2,"High",-2,2
"6412",38,197,1,1.3619,67,56,5,6,3,1,4,3,2,"High",-1,1
"6413",38,198,0,1.242,58,85,7,10,1,1,2,1,2,"Low",-3,3
"6414",38,199,0,1.0142,48,108,8,8,4,2,6,2,2,"High",0,0
"6415",38,200,0,1.0712,113,55,4,3,4,2,6,2,2,"High",1,1
"6416",39,1,1,1.9949,32,112,7,8,0,0,0,0,4,"Low",-1,1
"6417",39,2,0,1.2834,102,114,4,8,0,0,0,0,4,"Low",-4,4
"6418",39,3,1,2.8957,87,85,6,5,0,0,0,0,4,"Low",1,1
"6419",39,4,0,5.3631,105,21,8,9,0,0,0,0,4,"Low",-1,1
"6420",39,5,0,4.711,76,98,2,6,0,0,0,0,4,"Low",-4,4
"6421",39,6,0,3.6291,139,27,8,7,0,0,0,0,4,"Low",1,1
"6422",39,7,0,4.7306,85,99,5,10,1,0,1,0,4,"Low",-5,5
"6423",39,8,1,3.8314,92,72,3,2,0,0,0,0,4,"Low",1,1
"6424",39,9,0,6.1092,85,66,5,10,2,0,2,0,4,"Low",-5,5
"6425",39,10,1,2.7822,20,26,10,8,0,0,0,0,4,"Low",2,2
"6426",39,11,1,3.0942,41,84,7,2,0,0,0,0,4,"Low",5,5
"6427",39,12,0,2.7203,49,21,4,9,0,1,1,1,4,"Low",-5,5
"6428",39,13,1,3.951,17,100,10,9,0,0,0,0,4,"Low",1,1
"6429",39,14,0,1.6772,36,121,2,4,0,0,0,0,4,"Low",-2,2
"6430",39,15,0,11.8763,73,18,10,10,0,0,0,0,4,"Low",0,0
"6431",39,16,0,3.4908,89,85,2,5,0,3,3,3,4,"Low",-3,3
"6432",39,17,1,6.0212,134,132,6,9,0,0,0,0,4,"Low",-3,3
"6433",39,18,0,1.6549,89,79,2,6,1,0,1,0,4,"Low",-4,4
"6434",39,19,1,1.7582,21,85,9,5,2,4,6,2,4,"High",4,4
"6435",39,20,0,4.9433,25,14,6,10,0,0,0,0,4,"Low",-4,4
"6436",39,21,0,1.9669,101,35,2,7,0,0,0,0,4,"Low",-5,5
"6437",39,22,0,1.6032,79,117,6,10,1,0,1,0,4,"Low",-4,4
"6438",39,23,0,1.7584,122,31,6,8,0,0,0,0,4,"Low",-2,2
"6439",39,24,1,1.9172,63,99,10,10,0,1,1,0,4,"Low",0,0
"6440",39,25,0,4.5204,25,105,6,8,1,1,2,1,4,"Low",-2,2
"6441",39,26,1,6.8931,55,84,4,2,0,1,1,0,4,"Low",2,2
"6442",39,27,0,7.5567,125,44,3,2,0,0,0,0,4,"Low",1,1
"6443",39,28,1,8.725,93,32,7,7,0,1,1,0,4,"Low",0,0
"6444",39,29,0,1.2808,55,139,4,8,1,1,2,1,4,"Low",-4,4
"6445",39,30,0,2.1729,47,1,1,5,0,0,0,0,4,"Low",-4,4
"6446",39,31,1,2.4654,140,16,7,8,0,0,0,0,4,"Low",-1,1
"6447",39,32,1,3.8463,102,101,4,2,1,1,2,1,4,"Low",2,2
"6448",39,33,1,5.9615,17,21,10,9,1,3,4,1,4,"Low",1,1
"6449",39,34,1,1.9612,146,26,10,8,0,1,1,0,4,"Low",2,2
"6450",39,35,1,15.0113,41,63,7,10,1,1,2,1,4,"Low",-3,3
"6451",39,36,1,17.683,67,31,10,8,0,1,1,0,4,"Low",2,2
"6452",39,37,1,4.8422,67,31,10,8,1,2,3,1,4,"Low",2,2
"6453",39,38,1,10.2212,17,104,10,9,2,0,2,2,4,"Low",1,1
"6454",39,39,0,1.7685,104,114,9,8,1,1,2,1,4,"Low",1,1
"6455",39,40,1,1.8122,140,16,7,8,1,1,2,1,4,"Low",-1,1
"6456",39,41,1,4.7191,17,31,10,8,3,3,6,3,4,"High",2,2
"6457",39,42,1,2.1984,87,101,6,2,1,2,3,1,4,"Low",4,4
"6458",39,43,1,3.8379,87,100,6,9,2,1,3,2,4,"Low",-3,3
"6459",39,44,1,1.9447,49,95,4,1,1,0,1,1,4,"Low",3,3
"6460",39,45,1,13.267,31,55,8,4,4,2,6,4,4,"High",4,4
"6461",39,46,1,1.607,117,63,10,10,1,2,3,1,4,"Low",0,0
"6462",39,47,1,1.7074,146,139,10,8,1,2,3,1,4,"Low",2,2
"6463",39,48,1,9.6321,32,134,7,6,2,1,3,2,4,"Low",1,1
"6464",39,49,0,1.4001,100,146,9,10,2,2,4,2,4,"Low",-1,1
"6465",39,50,1,1.5909,98,97,6,6,1,0,1,1,4,"Low",0,0
"6466",39,51,1,3.0629,65,26,5,8,0,2,2,0,4,"Low",-3,3
"6467",39,52,0,2.6763,90,123,1,3,0,0,0,0,4,"Low",-2,2
"6468",39,53,0,6.0558,98,99,6,10,2,2,4,2,4,"Low",-4,4
"6469",39,54,1,10.6936,112,104,8,9,1,2,3,1,4,"Low",-1,1
"6470",39,55,0,3.7633,134,121,6,4,2,1,3,1,4,"Low",2,2
"6471",39,56,1,4.4441,132,34,9,6,1,0,1,1,4,"Low",3,3
"6472",39,57,1,5.986,134,34,6,6,3,1,4,3,4,"Low",0,0
"6473",39,58,0,1.0037,102,87,4,6,2,3,5,3,4,"High",-2,2
"6474",39,59,0,1.1319,129,65,2,5,0,1,1,1,4,"Low",-3,3
"6475",39,60,1,1.0133,146,25,10,6,3,2,5,3,4,"High",4,4
"6476",39,61,0,1.9482,1,63,5,10,1,3,4,3,4,"Low",-5,5
"6477",39,62,0,1.9351,98,99,6,10,3,3,6,3,4,"High",-4,4
"6478",39,63,1,3.2617,9,122,4,6,0,1,1,0,4,"Low",-2,2
"6479",39,64,1,1.8598,65,38,5,1,2,0,2,2,4,"Low",4,4
"6480",39,65,1,8.3957,139,26,8,8,3,3,6,3,4,"High",0,0
"6481",39,66,0,4.3259,134,140,6,7,4,2,6,2,4,"High",-1,1
"6482",39,67,0,10.3357,63,27,10,7,4,1,5,1,4,"High",3,3
"6483",39,68,1,1.9136,20,122,10,6,1,2,3,1,4,"Low",4,4
"6484",39,69,1,5.2207,112,50,8,6,2,0,2,2,4,"Low",2,2
"6485",39,70,0,3.6115,21,66,9,10,4,1,5,1,4,"High",-1,1
"6486",39,71,0,2.7616,44,125,2,3,1,1,2,1,4,"Low",-1,1
"6487",39,72,0,1.0192,118,146,10,10,0,4,4,4,4,"Low",0,0
"6488",39,73,0,1.3652,1,74,5,8,2,0,2,0,4,"Low",-3,3
"6489",39,74,0,2.5289,16,26,8,8,2,4,6,4,4,"High",0,0
"6490",39,75,1,3.4102,34,133,6,4,2,0,2,2,4,"Low",2,2
"6491",39,76,0,6.7316,76,89,2,2,1,2,3,2,4,"Low",0,0
"6492",39,77,1,11.2929,117,118,10,10,2,1,3,2,4,"Low",0,0
"6493",39,78,0,1.8424,54,113,7,10,0,0,0,0,4,"Low",-3,3
"6494",39,79,0,6.7766,72,38,2,1,1,1,2,1,4,"Low",1,1
"6495",39,80,1,2.1767,20,14,10,10,2,1,3,2,4,"Low",0,0
"6496",39,81,0,2.9654,122,9,6,4,3,1,4,1,4,"Low",2,2
"6497",39,82,1,1.9622,97,92,6,3,1,1,2,1,4,"Low",3,3
"6498",39,83,0,2.8887,102,54,4,7,3,1,4,1,4,"Low",-3,3
"6499",39,84,0,2.417,72,25,2,6,2,3,5,3,4,"High",-4,4
"6500",39,85,0,2.049,32,114,7,8,3,2,5,2,4,"High",-1,1
"6501",39,86,1,2.6456,125,43,3,1,2,0,2,2,4,"Low",2,2
"6502",39,87,0,1.2997,34,119,6,10,3,0,3,0,4,"Low",-4,4
"6503",39,88,0,6.3497,92,87,3,6,2,4,6,4,4,"High",-3,3
"6504",39,89,0,7.0458,36,84,2,2,1,2,3,2,4,"Low",0,0
"6505",39,90,0,1.7001,25,140,6,7,4,3,7,3,4,"High",-1,1
"6506",39,91,0,4.1494,54,98,7,6,2,4,6,4,4,"High",1,1
"6507",39,92,1,1.6489,79,38,6,1,2,2,4,2,4,"Low",5,5
"6508",39,93,0,4.574,1,14,5,10,3,2,5,2,4,"High",-5,5
"6509",39,94,0,2.9737,84,97,2,6,3,2,5,2,4,"High",-4,4
"6510",39,95,1,1.7695,113,140,10,7,1,4,5,1,4,"High",3,3
"6511",39,96,1,2.9976,105,133,8,4,2,1,3,2,4,"Low",4,4
"6512",39,97,0,14.224,54,144,7,4,3,0,3,0,4,"Low",3,3
"6513",39,98,1,7.637,123,72,3,2,1,3,4,1,4,"Low",1,1
"6514",39,99,1,20.0561,121,43,4,1,2,1,3,2,4,"Low",3,3
"6515",39,100,0,6.1329,2,27,7,7,0,2,2,2,4,"Low",0,0
"6516",39,101,1,1.4518,67,27,10,7,2,3,5,2,4,"High",3,3
"6517",39,102,0,1.9399,122,35,6,7,4,1,5,1,4,"High",-1,1
"6518",39,103,0,1.5055,16,114,8,8,3,3,6,3,4,"High",0,0
"6519",39,104,0,5.1501,32,16,7,8,4,4,8,4,4,"High",-1,1
"6520",39,105,0,5.5249,100,18,9,10,3,1,4,1,4,"Low",-1,1
"6521",39,106,1,4.3962,125,105,3,8,3,3,6,3,4,"High",-5,5
"6522",39,107,1,1.5957,118,2,10,7,2,1,3,2,4,"Low",3,3
"6523",39,108,0,1.6691,55,121,4,4,3,3,6,3,4,"High",0,0
"6524",39,109,1,1.4705,129,95,2,1,1,1,2,1,4,"Low",1,1
"6525",39,110,1,1.5639,79,105,6,8,3,4,7,3,4,"High",-2,2
"6526",39,111,0,3.1199,43,50,1,6,2,1,3,1,4,"Low",-5,5
"6527",39,112,1,1.3247,79,121,6,4,4,4,8,4,4,"High",2,2
"6528",39,113,0,1.8466,76,35,2,7,2,2,4,2,4,"Low",-5,5
"6529",39,114,1,8.4279,132,144,9,4,2,1,3,2,4,"Low",5,5
"6530",39,115,1,9.1191,139,97,8,6,4,3,7,4,4,"High",2,2
"6531",39,116,0,2.3416,35,62,7,9,3,0,3,0,4,"Low",-2,2
"6532",39,117,1,3.5016,36,133,2,4,2,2,4,2,4,"Low",-2,2
"6533",39,118,1,1.3915,27,44,7,2,4,2,6,4,4,"High",5,5
"6534",39,119,1,1.4531,66,35,10,7,2,4,6,2,4,"High",3,3
"6535",39,120,0,2.3031,72,83,2,1,4,0,4,0,4,"Low",1,1
"6536",39,121,1,1.677,1,95,5,1,4,2,6,4,4,"High",4,4
"6537",39,122,0,1.3199,47,97,1,6,1,4,5,4,4,"High",-5,5
"6538",39,123,0,1.4346,133,112,4,8,3,3,6,3,4,"High",-4,4
"6539",39,124,0,1.1099,14,119,10,10,3,1,4,1,4,"Low",0,0
"6540",39,125,1,2.1192,93,102,7,4,1,4,5,1,4,"High",3,3
"6541",39,126,1,4.742,41,49,7,4,2,2,4,2,4,"Low",3,3
"6542",39,127,1,2.1919,41,133,7,4,3,4,7,3,4,"High",3,3
"6543",39,128,0,2.1662,62,114,9,8,1,4,5,4,4,"High",1,1
"6544",39,129,0,3.0515,48,9,6,4,0,2,2,2,4,"Low",2,2
"6545",39,130,0,1.5068,55,132,4,9,4,3,7,3,4,"High",-5,5
"6546",39,131,0,1.3897,103,129,4,2,0,2,2,2,4,"Low",2,2
"6547",39,132,0,2.3323,66,117,10,10,3,3,6,3,4,"High",0,0
"6548",39,133,1,2.4756,2,125,7,3,2,4,6,2,4,"High",4,4
"6549",39,134,1,7.2975,113,18,10,10,2,2,4,2,4,"Low",0,0
"6550",39,135,0,2.5632,76,144,2,4,3,2,5,2,4,"High",-2,2
"6551",39,136,1,2.2619,119,18,10,10,2,3,5,2,4,"High",0,0
"6552",39,137,0,1.8424,48,129,6,2,1,3,4,3,4,"Low",4,4
"6553",39,138,1,1.2419,20,74,10,8,3,1,4,3,4,"Low",2,2
"6554",39,139,1,2.2153,144,101,4,2,3,3,6,3,4,"High",2,2
"6555",39,140,0,1.2752,14,67,10,10,4,3,7,3,4,"High",0,0
"6556",39,141,1,3.0052,100,74,9,8,4,2,6,4,4,"High",1,1
"6557",39,142,0,1.4146,2,118,7,10,3,3,6,3,4,"High",-3,3
"6558",39,143,0,12.4532,44,43,2,1,3,3,6,3,4,"High",1,1
"6559",39,144,0,3.669,36,44,2,2,3,4,7,4,4,"High",0,0
"6560",39,145,1,1.6938,50,129,6,2,2,4,6,2,4,"High",4,4
"6561",39,146,1,3.3777,20,99,10,10,4,4,8,4,4,"High",0,0
"6562",39,147,0,3.2699,9,50,4,6,3,3,6,3,4,"High",-2,2
"6563",39,148,0,5.7012,76,50,2,6,4,4,8,4,4,"High",-4,4
"6564",39,149,1,2.3093,103,90,4,1,1,1,2,1,4,"Low",3,3
"6565",39,150,1,1.1906,117,112,10,8,4,4,8,4,4,"High",2,2
"6566",39,151,1,1.3014,113,73,10,10,3,1,4,3,4,"Low",0,0
"6567",39,152,1,3.7455,9,92,4,3,4,3,7,4,4,"High",1,1
"6568",39,153,0,2.8389,48,123,6,3,2,2,4,2,4,"Low",3,3
"6569",39,154,0,2.6024,49,89,4,2,3,3,6,3,4,"High",2,2
"6570",39,155,1,8.7783,41,2,7,7,4,4,8,4,4,"High",0,0
"6571",39,156,0,1.2399,103,65,4,5,2,3,5,3,4,"High",-1,1
"6572",39,157,1,4.2837,83,49,1,4,1,4,5,1,4,"High",-3,3
"6573",39,158,0,5.4483,47,38,1,1,2,3,5,3,4,"High",0,0
"6574",39,159,1,3.7965,66,62,10,9,4,2,6,4,4,"High",1,1
"6575",39,160,0,1.5601,36,92,2,3,4,4,8,4,4,"High",-1,1
"6576",39,161,0,2.2781,123,83,3,1,3,2,5,2,4,"High",2,2
"6577",39,162,0,1.0016,47,65,1,5,3,4,7,4,4,"High",-4,4
"6578",39,163,0,1.3667,95,89,1,2,3,4,7,4,4,"High",-1,1
"6579",39,164,1,10.4779,90,47,1,1,2,4,6,2,4,"High",0,0
"6580",39,165,0,2.2739,34,93,6,7,4,2,6,2,4,"High",-1,1
"6581",39,166,1,1.5151,113,54,10,7,4,4,8,4,4,"High",3,3
"6582",39,167,0,2.0917,43,84,1,2,4,4,8,4,4,"High",-1,1
"6583",39,168,1,3.9745,144,90,4,1,4,3,7,4,4,"High",3,3
"6584",39,169,1,2.9391,62,93,9,7,3,3,6,3,4,"High",2,2
"6585",39,170,1,7.3699,101,123,2,3,4,4,8,4,4,"High",-1,1
"6586",39,171,0,5.3881,67,118,10,10,4,4,8,4,4,"High",0,0
"6587",39,172,0,8.5367,90,38,1,1,4,4,8,4,4,"High",0,0
"6588",39,173,1,1.2361,17,62,10,9,4,4,8,4,4,"High",1,1
"6589",39,174,1,1.5735,18,48,10,6,4,3,7,4,4,"High",4,4
"6590",39,175,0,1.4178,104,119,9,10,3,3,6,3,4,"High",-1,1
"6591",39,176,0,2.3915,93,104,7,9,4,4,8,4,4,"High",-2,2
"6592",39,177,0,2.293,73,132,10,9,2,4,6,4,4,"High",1,1
"6593",39,178,1,1.8891,103,48,4,6,3,4,7,3,4,"High",-2,2
"6594",39,179,0,3.281,103,74,4,8,4,3,7,3,4,"High",-4,4
"6595",39,180,0,2.8879,73,119,10,10,3,4,7,4,4,"High",0,0
"6596",39,181,0,5.618,74,73,8,10,4,4,8,4,4,"High",-2,2
"6597",40,1,1,0.92277,1,2,5,2,0,0,0,0,4,"Low",3,3
"6598",40,2,1,1.2038,35,41,8,7,0,0,0,0,4,"Low",1,1
"6599",40,3,0,1.0098,26,147,2,2,0,0,0,0,4,"Low",0,0
"6600",40,4,1,0.77593,41,83,7,10,1,0,1,1,4,"Low",-3,3
"6601",40,5,1,0.9673,73,26,3,2,0,1,1,0,4,"Low",1,1
"6602",40,6,1,1.1664,86,66,7,6,0,0,0,0,4,"Low",1,1
"6603",40,7,0,0.98978,100,2,6,2,0,1,1,1,4,"Low",4,4
"6604",40,8,0,1.6685,31,35,8,8,0,1,1,1,4,"Low",0,0
"6605",40,9,1,1.0401,87,84,5,9,0,0,0,0,4,"Low",-4,4
"6606",40,10,0,1.7687,66,31,6,8,1,1,2,1,4,"Low",-2,2
"6607",40,11,0,1.0806,73,129,3,3,1,0,1,0,4,"Low",0,0
"6608",40,12,1,0.71551,114,66,7,6,0,2,2,0,4,"Low",1,1
"6609",40,13,1,1.0527,134,21,4,3,0,0,0,0,4,"Low",1,1
"6610",40,14,1,1.3927,53,129,2,3,0,1,1,0,4,"Low",-1,1
"6611",40,15,0,0.6634,14,140,5,6,0,0,0,0,4,"Low",-1,1
"6612",40,16,1,0.68314,83,87,10,5,1,1,2,1,4,"Low",5,5
"6613",40,17,0,1.0055,96,41,3,7,0,2,2,2,4,"Low",-4,4
"6614",40,18,1,0.79835,29,14,10,5,0,1,1,0,4,"Low",5,5
"6615",40,19,1,0.66175,86,132,7,2,1,0,1,1,4,"Low",5,5
"6616",40,20,0,0.88437,119,114,5,7,0,1,1,1,4,"Low",-2,2
"6617",40,21,1,1.391,89,101,9,6,0,0,0,0,4,"Low",3,3
"6618",40,22,0,0.76918,139,34,7,7,0,0,0,0,4,"Low",0,0
"6619",40,23,0,0.88055,14,110,5,4,2,0,2,0,4,"Low",1,1
"6620",40,24,1,0.64953,41,1,7,5,3,1,4,3,4,"Low",2,2
"6621",40,25,0,1.1672,65,41,6,7,0,4,4,4,4,"Low",-1,1
"6622",40,26,1,0.73571,82,20,2,7,0,0,0,0,4,"Low",-5,5
"6623",40,27,0,1.2474,12,101,3,6,0,1,1,1,4,"Low",-3,3
"6624",40,28,1,0.65207,34,65,7,6,1,1,2,1,4,"Low",1,1
"6625",40,29,0,1.3754,63,99,2,7,0,0,0,0,4,"Low",-5,5
"6626",40,30,0,0.61463,26,74,2,5,2,0,2,0,4,"Low",-3,3
"6627",40,31,0,1.3559,63,87,2,5,1,2,3,2,4,"Low",-3,3
"6628",40,32,1,1.1318,89,65,9,6,1,2,3,1,4,"Low",3,3
"6629",40,33,1,0.70369,101,129,6,3,2,2,4,2,4,"Low",3,3
"6630",40,34,1,0.78549,97,114,9,7,0,2,2,0,4,"Low",2,2
"6631",40,35,1,0.7328,114,101,7,6,3,3,6,3,4,"High",1,1
"6632",40,36,0,0.86527,1,8,5,1,2,0,2,0,4,"Low",4,4
"6633",40,37,1,1.4841,130,140,1,6,0,1,1,0,4,"Low",-5,5
"6634",40,38,1,0.7828,52,12,2,3,0,1,1,0,4,"Low",-1,1
"6635",40,39,1,0.82443,20,14,7,5,1,3,4,1,4,"Low",2,2
"6636",40,40,1,1.0609,85,63,5,2,0,2,2,0,4,"Low",3,3
"6637",40,41,0,0.64363,83,89,10,9,2,2,4,2,4,"Low",1,1
"6638",40,42,0,0.69625,113,29,5,10,0,1,1,1,4,"Low",-5,5
"6639",40,43,0,0.97906,74,130,5,1,1,1,2,1,4,"Low",4,4
"6640",40,44,1,0.78547,8,63,1,2,1,3,4,1,4,"Low",-1,1
"6641",40,45,1,1.5519,29,30,10,7,2,0,2,2,4,"Low",3,3
"6642",40,46,1,0.65589,34,20,7,7,2,2,4,2,4,"Low",0,0
"6643",40,47,1,0.88382,87,62,5,1,3,0,3,3,4,"Low",4,4
"6644",40,48,0,0.58667,132,140,2,6,1,2,3,2,4,"Low",-4,4
"6645",40,49,1,0.60916,50,114,4,7,0,4,4,0,4,"Low",-3,3
"6646",40,50,1,0.90322,62,37,1,1,1,0,1,1,4,"Low",0,0
"6647",40,51,0,0.77859,12,121,3,7,2,0,2,0,4,"Low",-4,4
"6648",40,52,0,1.0914,100,17,6,1,1,0,1,0,4,"Low",5,5
"6649",40,53,1,1.2182,83,87,10,5,3,4,7,3,4,"High",5,5
"6650",40,54,1,1.0876,111,63,1,2,0,4,4,0,4,"Low",-1,1
"6651",40,55,1,0.88216,147,100,2,6,1,2,3,1,4,"Low",-4,4
"6652",40,56,1,0.80813,110,55,4,3,1,0,1,1,4,"Low",1,1
"6653",40,57,0,0.56615,119,139,5,7,1,1,2,1,4,"Low",-2,2
"6654",40,58,1,0.62161,98,89,7,9,0,3,3,0,4,"Low",-2,2
"6655",40,59,1,0.88029,99,121,7,7,1,1,2,1,4,"Low",0,0
"6656",40,60,0,0.68569,85,86,5,7,1,2,3,2,4,"Low",-2,2
"6657",40,61,1,1.5045,122,14,10,5,0,4,4,0,4,"Low",5,5
"6658",40,62,0,1.1476,134,94,4,2,1,0,1,0,4,"Low",2,2
"6659",40,63,0,0.98253,52,113,2,5,1,1,2,1,4,"Low",-3,3
"6660",40,64,1,0.79059,25,147,7,2,0,2,2,0,4,"Low",5,5
"6661",40,65,0,1.0932,53,96,2,3,1,1,2,1,4,"Low",-1,1
"6662",40,66,1,0.59603,2,62,2,1,2,2,4,2,4,"Low",1,1
"6663",40,67,0,0.85046,98,110,7,4,1,2,3,2,4,"Low",3,3
"6664",40,68,1,0.74852,86,84,7,9,3,1,4,3,4,"Low",-2,2
"6665",40,69,1,0.71067,130,1,1,5,2,3,5,2,4,"High",-4,4
"6666",40,70,1,0.63252,101,119,6,5,4,2,6,4,4,"High",1,1
"6667",40,71,1,0.84542,122,140,10,6,1,3,4,1,4,"Low",4,4
"6668",40,72,0,0.87194,21,94,3,2,1,1,2,1,4,"Low",1,1
"6669",40,73,1,0.54149,31,129,8,3,2,3,5,2,4,"High",5,5
"6670",40,74,1,1.0002,134,37,4,1,2,1,3,2,4,"Low",3,3
"6671",40,75,1,0.81422,94,12,2,3,2,3,5,2,4,"High",-1,1
"6672",40,76,1,0.67811,34,30,7,7,3,1,4,3,4,"Low",0,0
"6673",40,77,1,0.61101,31,58,8,10,3,0,3,3,4,"Low",-2,2
"6674",40,78,1,0.87292,119,82,5,2,3,1,4,3,4,"Low",3,3
"6675",40,79,1,1.2362,129,82,3,2,4,2,6,4,4,"High",1,1
"6676",40,80,0,1.153,140,84,6,9,4,2,6,2,4,"High",-3,3
"6677",40,81,0,1.153,100,53,6,2,3,2,5,2,4,"High",4,4
"6678",40,82,1,0.60911,30,96,7,3,2,2,4,2,4,"Low",4,4
"6679",40,83,1,1.2391,17,8,1,1,1,2,3,1,4,"Low",0,0
"6680",40,84,0,0.73238,37,119,1,5,2,4,6,4,4,"High",-4,4
"6681",40,85,1,0.58923,20,12,7,3,3,4,7,3,4,"High",4,4
"6682",40,86,0,0.59585,110,97,4,9,3,1,4,1,4,"Low",-5,5
"6683",40,87,1,0.58474,50,121,4,7,1,2,3,1,4,"Low",-3,3
"6684",40,88,1,0.65526,85,1,5,5,2,4,6,2,4,"High",0,0
"6685",40,89,1,1.2191,139,21,7,3,2,2,4,2,4,"Low",4,4
"6686",40,90,1,0.65678,84,99,9,7,3,2,5,3,4,"High",2,2
"6687",40,91,1,0.51073,34,82,7,2,4,3,7,4,4,"High",5,5
"6688",40,92,0,3.8807,31,74,8,5,4,2,6,2,4,"High",3,3
"6689",40,93,0,0.90615,121,84,7,9,3,4,7,4,4,"High",-2,2
"6690",40,94,1,0.59725,89,134,9,4,4,3,7,4,4,"High",5,5
"6691",40,95,0,1.2507,55,2,3,2,1,3,4,3,4,"Low",1,1
"6692",40,96,1,0.60537,62,2,1,2,3,4,7,3,4,"High",-1,1
"6693",40,97,1,1.0276,122,97,10,9,2,2,4,2,4,"Low",1,1
"6694",40,98,0,0.92088,73,30,3,7,2,3,5,3,4,"High",-4,4
"6695",40,99,1,1.0262,94,111,2,1,3,1,4,3,4,"Low",1,1
"6696",40,100,0,1.0637,100,25,6,7,4,1,5,1,4,"High",-1,1
"6697",40,101,0,0.63245,30,20,7,7,4,4,8,4,4,"High",0,0
"6698",40,102,1,1.0631,21,55,3,3,3,2,5,3,4,"High",0,0
"6699",40,103,1,0.98036,62,82,1,2,4,4,8,4,4,"High",-1,1
"6700",40,104,0,1.3172,85,25,5,7,3,2,5,2,4,"High",-2,2
"6701",40,105,0,0.79182,65,122,6,10,3,3,6,3,4,"High",-4,4
"6702",40,106,1,0.59864,25,97,7,9,3,3,6,3,4,"High",-2,2
"6703",40,107,1,0.68011,35,55,8,3,2,3,5,2,4,"High",5,5
"6704",40,108,0,0.61659,99,124,7,9,3,0,3,0,4,"Low",-2,2
"6705",40,109,0,0.9712,111,96,1,3,2,3,5,3,4,"High",-2,2
"6706",40,110,0,0.78619,26,98,2,7,3,2,5,2,4,"High",-5,5
"6707",40,111,0,0.94473,132,65,2,6,2,4,6,4,4,"High",-4,4
"6708",40,112,1,0.82537,139,132,7,2,3,3,6,3,4,"High",5,5
"6709",40,113,0,1.2067,26,121,2,7,4,4,8,4,4,"High",-5,5
"6710",40,114,1,1.0131,53,52,2,2,3,2,5,3,4,"High",0,0
"6711",40,115,0,1.0021,130,110,1,4,3,4,7,4,4,"High",-3,3
"6712",40,116,1,0.73415,124,86,9,7,1,4,5,1,4,"High",2,2
"6713",40,117,1,0.81431,134,66,4,6,4,3,7,4,4,"High",-2,2
"6714",40,118,0,0.71191,66,124,6,9,4,2,6,2,4,"High",-3,3
"6715",40,119,0,0.78227,73,25,3,7,3,4,7,4,4,"High",-4,4
"6716",40,120,1,0.95646,17,37,1,1,2,3,5,2,4,"High",0,0
"6717",40,121,1,0.8123,98,96,7,3,3,4,7,3,4,"High",4,4
"6718",40,122,0,0.60246,21,37,3,1,4,4,8,4,4,"High",2,2
"6719",40,123,0,0.72963,75,122,10,10,0,4,4,4,4,"Low",0,0
"6720",40,124,1,0.861,17,94,1,2,3,4,7,3,4,"High",-1,1
"6721",40,125,1,0.69722,83,113,10,5,4,2,6,4,4,"High",5,5
"6722",40,126,0,1.2258,58,98,10,7,1,4,5,4,4,"High",3,3
"6723",40,127,1,0.96139,147,55,2,3,3,4,7,3,4,"High",-1,1
"6724",40,128,1,1.0921,132,8,2,1,4,3,7,4,4,"High",1,1
"6725",40,129,1,1.6547,53,73,2,3,4,4,8,4,4,"High",-1,1
"6726",40,130,0,0.72268,124,29,9,10,3,3,6,3,4,"High",-1,1
"6727",40,131,0,1.0281,113,99,5,7,3,4,7,4,4,"High",-2,2
"6728",40,132,0,0.88939,85,52,5,2,4,3,7,3,4,"High",3,3
"6729",40,133,1,0.62821,35,113,8,5,3,4,7,3,4,"High",3,3
"6730",40,134,1,0.56335,35,75,8,10,4,1,5,4,4,"High",-2,2
"6731",40,135,1,0.79477,147,50,2,4,4,2,6,4,4,"High",-2,2
"6732",40,136,0,0.98543,74,130,5,1,3,4,7,4,4,"High",4,4
"6733",40,137,0,1.0735,111,74,1,5,3,4,7,4,4,"High",-4,4
"6734",40,138,1,0.8837,52,111,2,1,4,4,8,4,4,"High",1,1
"6735",40,139,1,0.77572,97,58,9,10,4,2,6,4,4,"High",-1,1
"6736",40,140,0,0.56579,75,139,10,7,2,4,6,4,4,"High",3,3
"6737",40,141,0,0.7017,75,124,10,9,3,4,7,4,4,"High",1,1
"6738",40,142,0,1.1831,75,29,10,10,4,4,8,4,4,"High",0,0
"6739",40,143,1,0.79789,17,8,1,1,4,4,8,4,4,"High",0,0
"6740",41,1,1,2.0224,48,101,2,4,0,0,0,0,4,"Low",-2,2
"6741",41,2,0,2.8676,18,14,4,8,0,0,0,0,4,"Low",-4,4
"6742",41,3,1,1.2083,71,33,2,4,0,0,0,0,4,"Low",-2,2
"6743",41,4,0,5.5265,62,107,6,5,0,0,0,0,4,"Low",1,1
"6744",41,5,0,1.7356,15,110,2,4,0,0,0,0,4,"Low",-2,2
"6745",41,6,1,1.8563,72,101,6,4,0,1,1,0,4,"Low",2,2
"6746",41,7,1,2.5326,122,107,5,5,0,1,1,0,4,"Low",0,0
"6747",41,8,1,2.9734,122,62,5,6,1,1,2,1,4,"Low",-1,1
"6748",41,9,0,1.7587,129,98,4,5,0,0,0,0,4,"Low",-1,1
"6749",41,10,0,1.7927,143,77,5,3,0,0,0,0,4,"Low",2,2
"6750",41,11,1,2.1993,105,126,4,7,0,0,0,0,4,"Low",-3,3
"6751",41,12,0,1.9141,63,79,8,4,0,0,0,0,4,"Low",4,4
"6752",41,13,0,2.3474,19,134,3,8,0,0,0,0,4,"Low",-5,5
"6753",41,14,0,1.5154,117,134,4,8,0,1,1,1,4,"Low",-4,4
"6754",41,15,1,2.6368,43,140,6,2,0,0,0,0,4,"Low",4,4
"6755",41,16,0,1.9375,9,7,2,5,0,0,0,0,4,"Low",-3,3
"6756",41,17,0,1.6342,14,72,8,6,1,1,2,1,4,"Low",2,2
"6757",41,18,0,1.5016,110,62,4,6,1,2,3,2,4,"Low",-2,2
"6758",41,19,0,3.5115,113,94,1,4,0,0,0,0,4,"Low",-3,3
"6759",41,20,0,1.3697,106,78,2,6,0,0,0,0,4,"Low",-4,4
"6760",41,21,0,4.4171,72,97,6,5,2,0,2,0,4,"Low",1,1
"6761",41,22,0,1.2464,62,78,6,6,3,1,4,1,4,"Low",0,0
"6762",41,23,1,1.2031,79,68,4,2,1,0,1,1,4,"Low",2,2
"6763",41,24,1,1.585,140,101,2,4,1,2,3,1,4,"Low",-2,2
"6764",41,25,0,1.3358,58,52,5,5,0,0,0,0,4,"Low",0,0
"6765",41,26,0,2.5126,3,52,2,5,0,1,1,1,4,"Low",-3,3
"6766",41,27,0,1.6374,114,14,4,8,0,2,2,2,4,"Low",-4,4
"6767",41,28,1,3.1061,24,78,2,6,0,2,2,0,4,"Low",-4,4
"6768",41,29,1,1.822,93,58,6,5,0,1,1,0,4,"Low",1,1
"6769",41,30,1,1.5233,27,126,6,7,0,1,1,0,4,"Low",-1,1
"6770",41,31,0,1.315,48,28,2,6,1,0,1,0,4,"Low",-4,4
"6771",41,32,1,2.4602,47,127,1,3,0,0,0,0,4,"Low",-2,2
"6772",41,33,1,1.352,28,4,6,4,1,0,1,1,4,"Low",2,2
"6773",41,34,0,1.7442,132,48,1,2,0,2,2,2,4,"Low",-1,1
"6774",41,35,1,3.6571,80,40,10,6,0,0,0,0,4,"Low",4,4
"6775",41,36,1,1.5489,39,15,5,2,0,1,1,0,4,"Low",3,3
"6776",41,37,0,1.5105,41,43,5,6,0,1,1,1,4,"Low",-1,1
"6777",41,38,0,1.4644,130,40,3,6,0,1,1,1,4,"Low",-3,3
"6778",41,39,0,2.0852,23,133,1,5,0,0,0,0,4,"Low",-4,4
"6779",41,40,0,1.0878,106,68,2,2,1,1,2,1,4,"Low",0,0
"6780",41,41,1,5.9542,127,42,3,7,1,0,1,1,4,"Low",-4,4
"6781",41,42,1,3.0672,94,114,4,4,1,1,2,1,4,"Low",0,0
"6782",41,43,0,0.82447,63,39,8,5,1,1,2,1,4,"Low",3,3
"6783",41,44,0,1.4301,33,79,4,4,1,2,3,2,4,"Low",0,0
"6784",41,45,0,1.3865,107,72,5,6,2,3,5,3,4,"High",-1,1
"6785",41,46,1,0.92798,44,105,4,4,0,1,1,0,4,"Low",0,0
"6786",41,47,1,2.7388,28,24,6,2,2,1,3,2,4,"Low",4,4
"6787",41,48,0,1.9061,97,14,5,8,1,3,4,3,4,"Low",-3,3
"6788",41,49,1,1.2435,127,13,3,4,2,0,2,2,4,"Low",-1,1
"6789",41,50,0,1.0482,13,94,4,4,1,2,3,2,4,"Low",0,0
"6790",41,51,0,1.218,100,43,8,6,0,2,2,2,4,"Low",2,2
"6791",41,52,0,1.375,70,86,4,4,0,0,0,0,4,"Low",0,0
"6792",41,53,0,2.3742,58,65,5,5,2,0,2,0,4,"Low",0,0
"6793",41,54,1,1.2055,105,62,4,6,2,4,6,2,4,"High",-2,2
"6794",41,55,1,1.9236,71,15,2,2,1,2,3,1,4,"Low",0,0
"6795",41,56,1,1.1993,66,105,6,4,0,3,3,0,4,"Low",2,2
"6796",41,57,0,1.4467,113,129,1,4,1,1,2,1,4,"Low",-3,3
"6797",41,58,1,1.5945,44,117,4,4,1,1,2,1,4,"Low",0,0
"6798",41,59,1,3.4012,133,70,5,4,1,1,2,1,4,"Low",1,1
"6799",41,60,1,4.9753,9,67,2,7,1,0,1,1,4,"Low",-5,5
"6800",41,61,1,3.296,118,14,10,8,0,4,4,0,4,"Low",2,2
"6801",41,62,0,1.3646,71,24,2,2,2,2,4,2,4,"Low",0,0
"6802",41,63,0,3.3354,126,64,7,2,2,0,2,0,4,"Low",5,5
"6803",41,64,1,1.6888,72,143,6,5,4,1,5,4,4,"High",1,1
"6804",41,65,1,1.5488,126,13,7,4,3,2,5,3,4,"High",3,3
"6805",41,66,1,1.3336,52,41,5,5,2,1,3,2,4,"Low",0,0
"6806",41,67,1,1.3744,98,110,5,4,1,2,3,1,4,"Low",1,1
"6807",41,68,0,0.92619,22,27,5,6,0,1,1,1,4,"Low",-1,1
"6808",41,69,0,0.92885,68,18,2,4,2,1,3,1,4,"Low",-2,2
"6809",41,70,1,3.5305,100,32,8,4,1,0,1,1,4,"Low",4,4
"6810",41,71,0,1.5205,39,37,5,2,2,0,2,0,4,"Low",3,3
"6811",41,72,0,1.4899,52,37,5,2,3,1,4,1,4,"Low",3,3
"6812",41,73,0,1.2623,68,44,2,4,3,2,5,2,4,"High",-2,2
"6813",41,74,0,1.8826,4,6,4,6,1,0,1,0,4,"Low",-2,2
"6814",41,75,0,2.3813,19,28,3,6,1,3,4,3,4,"Low",-3,3
"6815",41,76,1,1.4837,40,106,6,2,2,2,4,2,4,"Low",4,4
"6816",41,77,0,4.2446,78,105,6,4,3,4,7,4,4,"High",2,2
"6817",41,78,1,4.0661,69,115,2,6,0,0,0,0,4,"Low",-4,4
"6818",41,79,0,1.2489,47,43,1,6,1,3,4,3,4,"Low",-5,5
"6819",41,80,1,1.0525,118,22,10,5,1,1,2,1,4,"Low",5,5
"6820",41,81,1,0.96078,66,37,6,2,1,2,3,1,4,"Low",4,4
"6821",41,82,0,0.85073,39,58,5,5,3,3,6,3,4,"High",0,0
"6822",41,83,1,1.5188,104,127,7,3,0,3,3,0,4,"Low",4,4
"6823",41,84,1,1.4876,93,113,6,1,1,2,3,1,4,"Low",5,5
"6824",41,85,0,0.94054,33,140,4,2,2,2,4,2,4,"Low",2,2
"6825",41,86,1,1.1163,116,110,6,4,0,3,3,0,4,"Low",2,2
"6826",41,87,1,0.94244,66,101,6,4,2,3,5,2,4,"High",2,2
"6827",41,88,0,0.98394,41,65,5,5,2,1,3,1,4,"Low",0,0
"6828",41,89,0,1.8536,19,24,3,2,2,3,5,3,4,"High",1,1
"6829",41,90,1,1.4957,115,31,6,4,1,0,1,1,4,"Low",2,2
"6830",41,91,1,1.3478,97,33,5,4,2,3,5,2,4,"High",1,1
"6831",41,92,1,3.7718,52,146,5,6,4,0,4,4,4,"Low",-1,1
"6832",41,93,1,2.163,90,94,9,4,0,3,3,0,4,"Low",5,5
"6833",41,94,0,2.9905,67,7,7,5,1,1,2,1,4,"Low",2,2
"6834",41,95,0,2.2934,127,113,3,1,4,3,7,3,4,"High",2,2
"6835",41,96,0,2.9586,132,32,1,4,1,1,2,1,4,"Low",-3,3
"6836",41,97,0,1.1175,113,5,1,5,4,0,4,0,4,"Low",-4,4
"6837",41,98,0,2.6549,114,31,4,4,2,1,3,1,4,"Low",0,0
"6838",41,99,1,1.9069,98,67,5,7,2,2,4,2,4,"Low",-2,2
"6839",41,100,1,1.4535,94,23,4,1,4,1,5,4,4,"High",3,3
"6840",41,101,1,1.1761,97,114,5,4,3,3,6,3,4,"High",1,1
"6841",41,102,0,0.86488,22,100,5,8,2,2,4,2,4,"Low",-3,3
"6842",41,103,1,1.1971,117,141,4,7,2,0,2,2,4,"Low",-3,3
"6843",41,104,0,1.5991,19,91,3,5,3,0,3,0,4,"Low",-2,2
"6844",41,105,0,1.106,70,119,4,3,2,0,2,0,4,"Low",1,1
"6845",41,106,1,1.0103,141,126,7,7,1,4,5,1,4,"High",0,0
"6846",41,107,0,0.82445,27,66,6,6,2,3,5,3,4,"High",0,0
"6847",41,108,0,1.0618,39,70,5,4,4,3,7,3,4,"High",1,1
"6848",41,109,1,1.4437,122,110,5,4,2,4,6,2,4,"High",1,1
"6849",41,110,1,0.91449,82,117,3,4,0,3,3,0,4,"Low",-1,1
"6850",41,111,0,1.9957,132,48,1,2,2,3,5,3,4,"High",-1,1
"6851",41,112,1,1.4987,90,101,9,4,1,4,5,1,4,"High",5,5
"6852",41,113,0,3.2898,24,109,2,2,4,0,4,0,4,"Low",0,0
"6853",41,114,0,1.0366,22,91,5,5,3,1,4,1,4,"Low",0,0
"6854",41,115,0,1.5182,47,79,1,4,2,3,5,3,4,"High",-3,3
"6855",41,116,1,1.1815,115,109,6,2,2,1,3,2,4,"Low",4,4
"6856",41,117,1,1.6442,32,93,4,6,2,2,4,2,4,"Low",-2,2
"6857",41,118,0,0.95074,130,43,3,6,1,4,5,4,4,"High",-3,3
"6858",41,119,0,0.78302,68,65,2,5,4,2,6,2,4,"High",-3,3
"6859",41,120,0,1.1494,27,133,6,5,3,2,5,2,4,"High",1,1
"6860",41,121,0,1.1017,71,40,2,6,3,3,6,3,4,"High",-4,4
"6861",41,122,1,2.3836,99,27,7,6,0,4,4,0,4,"Low",1,1
"6862",41,123,0,1.0308,119,104,3,7,1,1,2,1,4,"Low",-4,4
"6863",41,124,0,1.3836,117,78,4,6,4,4,8,4,4,"High",-2,2
"6864",41,125,0,1.0965,130,4,3,4,2,2,4,2,4,"Low",-1,1
"6865",41,126,0,1.2525,118,66,10,6,2,4,6,4,4,"High",4,4
"6866",41,127,0,1.8645,119,102,3,2,2,0,2,0,4,"Low",1,1
"6867",41,128,1,1.1959,104,15,7,2,2,3,5,2,4,"High",5,5
"6868",41,129,0,1.146,41,65,5,5,3,3,6,3,4,"High",0,0
"6869",41,130,0,0.95411,146,58,6,5,1,4,5,4,4,"High",1,1
"6870",41,131,0,3.1673,102,103,2,4,1,0,1,0,4,"Low",-2,2
"6871",41,132,0,1.5739,19,7,3,5,4,2,6,2,4,"High",-2,2
"6872",41,133,1,1.8067,86,132,4,1,1,3,4,1,4,"Low",3,3
"6873",41,134,1,3.0928,91,93,5,6,2,3,5,2,4,"High",-1,1
"6874",41,135,1,1.0815,86,13,4,4,2,3,5,2,4,"High",0,0
"6875",41,136,0,2.1562,90,103,9,4,2,1,3,1,4,"Low",5,5
"6876",41,137,1,1.3947,134,4,8,4,2,3,5,2,4,"High",4,4
"6877",41,138,0,1.4103,97,77,5,3,4,1,5,1,4,"High",2,2
"6878",41,139,1,1.5534,141,145,7,4,2,0,2,2,4,"Low",3,3
"6879",41,140,1,2.7318,65,47,5,1,4,3,7,4,4,"High",4,4
"6880",41,141,0,1.1888,47,135,1,5,4,0,4,0,4,"Low",-4,4
"6881",41,142,0,1.5462,13,33,4,4,4,4,8,4,4,"High",0,0
"6882",41,143,0,2.2264,64,122,2,5,1,3,4,3,4,"Low",-3,3
"6883",41,144,1,1.1413,93,106,6,2,4,3,7,4,4,"High",4,4
"6884",41,145,0,1.0637,86,133,4,5,3,3,6,3,4,"High",-1,1
"6885",41,146,0,1.0009,67,115,7,6,3,3,6,3,4,"High",1,1
"6886",41,147,0,1.3772,132,146,1,6,4,2,6,2,4,"High",-5,5
"6887",41,148,1,0.96859,3,114,2,4,1,4,5,1,4,"High",-2,2
"6888",41,149,0,1.0813,48,104,2,7,4,3,7,3,4,"High",-5,5
"6889",41,150,1,1.6919,133,143,5,5,4,2,6,4,4,"High",0,0
"6890",41,151,0,1.9014,3,86,2,4,2,4,6,4,4,"High",-2,2
"6891",41,152,1,1.08,103,9,4,2,2,2,4,2,4,"Low",2,2
"6892",41,153,0,1.5787,116,4,6,4,1,4,5,4,4,"High",2,2
"6893",41,154,0,1.4983,103,28,4,6,3,4,7,4,4,"High",-2,2
"6894",41,155,0,1.19,17,99,8,7,0,1,1,1,4,"Low",1,1
"6895",41,156,0,1.5247,130,79,3,4,3,4,7,4,4,"High",-1,1
"6896",41,157,1,1.3022,107,109,5,2,3,2,5,3,4,"High",3,3
"6897",41,158,1,1.4496,18,145,4,4,2,1,3,2,4,"Low",0,0
"6898",41,159,1,1.3095,40,130,6,3,4,4,8,4,4,"High",3,3
"6899",41,160,0,1.6379,41,146,5,6,4,3,7,3,4,"High",-1,1
"6900",41,161,1,1.8904,129,37,4,2,2,3,5,2,4,"High",2,2
"6901",41,162,1,0.92982,82,64,3,2,1,2,3,1,4,"Low",1,1
"6902",41,163,0,0.91434,107,119,5,3,4,3,7,3,4,"High",2,2
"6903",41,164,1,1.2107,141,115,7,6,3,4,7,3,4,"High",1,1
"6904",41,165,0,1.2672,5,57,5,10,1,0,1,0,4,"Low",-5,5
"6905",41,166,0,2.3253,15,69,2,2,4,1,5,1,4,"High",0,0
"6906",41,167,1,0.79863,140,91,2,5,3,3,6,3,4,"High",-3,3
"6907",41,168,0,1.1614,18,146,4,6,3,4,7,4,4,"High",-2,2
"6908",41,169,0,0.64276,71,82,2,3,4,2,6,2,4,"High",-1,1
"6909",41,170,1,2.1174,109,64,2,2,3,3,6,3,4,"High",0,0
"6910",41,171,0,1.7179,140,6,2,6,4,1,5,1,4,"High",-4,4
"6911",41,172,1,1.1127,134,98,8,5,3,3,6,3,4,"High",3,3
"6912",41,173,0,1.0602,90,57,9,10,3,1,4,1,4,"Low",-1,1
"6913",41,174,0,1.0964,106,3,2,2,4,3,7,3,4,"High",0,0
"6914",41,175,1,0.89009,6,3,6,2,2,4,6,2,4,"High",4,4
"6915",41,176,1,1.8914,143,23,5,1,3,2,5,3,4,"High",4,4
"6916",41,177,1,1.3663,5,122,5,5,2,4,6,2,4,"High",0,0
"6917",41,178,1,1.6549,99,32,7,4,2,3,5,2,4,"High",3,3
"6918",41,179,0,1.523,77,116,3,6,2,2,4,2,4,"Low",-3,3
"6919",41,180,1,1.3565,116,69,6,2,3,2,5,3,4,"High",4,4
"6920",41,181,1,0.94832,103,23,4,1,4,3,7,4,4,"High",3,3
"6921",41,182,0,0.89235,63,5,8,5,2,3,5,3,4,"High",3,3
"6922",41,183,1,0.80705,87,5,10,5,0,4,4,0,4,"Low",5,5
"6923",41,184,1,1.3332,143,135,5,5,4,1,5,4,4,"High",0,0
"6924",41,185,1,1.9586,6,18,6,4,3,4,7,3,4,"High",2,2
"6925",41,186,0,0.71979,63,82,8,3,3,3,6,3,4,"High",5,5
"6926",41,187,0,0.75341,109,116,2,6,4,4,8,4,4,"High",-4,4
"6927",41,188,1,3.3613,67,9,7,2,4,3,7,4,4,"High",5,5
"6928",41,189,0,0.96879,80,8,10,10,1,0,1,0,4,"Low",0,0
"6929",41,190,1,1.5679,37,145,2,4,4,2,6,4,4,"High",-2,2
"6930",41,191,1,2.3486,104,118,7,10,4,3,7,4,4,"High",-3,3
"6931",41,192,0,2.8768,31,6,4,6,2,4,6,4,4,"High",-2,2
"6932",41,193,1,1.159,99,70,7,4,3,4,7,3,4,"High",3,3
"6933",41,194,0,0.82116,22,44,5,4,4,3,7,3,4,"High",1,1
"6934",41,195,0,0.73686,118,134,10,8,4,4,8,4,4,"High",2,2
"6935",41,196,1,1.4871,17,119,8,3,1,4,5,1,4,"High",5,5
"6936",41,197,0,0.81235,145,9,4,2,3,4,7,4,4,"High",2,2
"6937",41,198,0,1.0017,63,80,8,10,4,2,6,2,4,"High",-2,2
"6938",41,199,0,1.6318,17,7,8,5,2,3,5,3,4,"High",3,3
"6939",41,200,1,1.3489,7,31,5,4,4,3,7,4,4,"High",1,1
"6940",42,1,0,2.1165,55,17,2,3,0,0,0,0,4,"Low",-1,1
"6941",42,2,1,1.3321,50,132,2,1,0,0,0,0,4,"Low",1,1
"6942",42,3,0,0.94423,97,70,3,7,0,0,0,0,4,"Low",-4,4
"6943",42,4,0,1.7667,118,18,2,1,0,0,0,0,4,"Low",1,1
"6944",42,5,0,1.352,85,147,3,4,0,0,0,0,4,"Low",-1,1
"6945",42,6,1,1.0121,110,78,5,1,0,0,0,0,4,"Low",4,4
"6946",42,7,0,1.2812,28,66,3,3,0,0,0,0,4,"Low",0,0
"6947",42,8,0,1.2727,10,68,4,2,0,0,0,0,4,"Low",2,2
"6948",42,9,1,1.1136,105,87,2,2,0,0,0,0,4,"Low",0,0
"6949",42,10,0,1.4453,97,98,3,3,1,0,1,0,4,"Low",0,0
"6950",42,11,0,1.1769,77,37,1,2,0,0,0,0,4,"Low",-1,1
"6951",42,12,0,3.4873,72,108,5,4,0,0,0,0,4,"Low",1,1
"6952",42,13,0,0.9185,83,11,2,1,0,0,0,0,4,"Low",1,1
"6953",42,14,1,1.2803,141,17,4,3,0,1,1,0,4,"Low",1,1
"6954",42,15,0,2.0862,35,83,5,2,0,1,1,1,4,"Low",3,3
"6955",42,16,0,1.2342,33,117,2,6,0,0,0,0,4,"Low",-4,4
"6956",42,17,0,1.8032,50,13,2,2,1,0,1,0,4,"Low",0,0
"6957",42,18,0,1.7222,47,105,3,2,0,1,1,1,4,"Low",1,1
"6958",42,19,0,2.1516,10,33,4,2,1,1,2,1,4,"Low",2,2
"6959",42,20,0,1.2356,68,47,2,3,1,1,2,1,4,"Low",-1,1
"6960",42,21,0,1.0344,101,114,3,3,0,0,0,0,4,"Low",0,0
"6961",42,22,1,1.4951,99,144,3,2,0,0,0,0,4,"Low",1,1
"6962",42,23,1,1.0426,138,8,6,1,0,0,0,0,4,"Low",5,5
"6963",42,24,1,2.7353,113,69,4,6,0,0,0,0,4,"Low",-2,2
"6964",42,25,0,0.83079,97,33,3,2,2,2,4,2,4,"Low",1,1
"6965",42,26,1,0.83525,118,30,2,3,1,0,1,1,4,"Low",-1,1
"6966",42,27,1,1.8074,114,68,3,2,1,2,3,1,4,"Low",1,1
"6967",42,28,0,0.82863,40,147,4,4,0,1,1,1,4,"Low",0,0
"6968",42,29,0,0.78065,83,10,2,4,2,2,4,2,4,"Low",-2,2
"6969",42,30,1,0.84618,19,124,7,2,0,0,0,0,4,"Low",5,5
"6970",42,31,1,1.2814,72,144,5,2,1,1,2,1,4,"Low",3,3
"6971",42,32,0,2.4247,108,115,4,6,1,0,1,0,4,"Low",-2,2
"6972",42,33,0,0.79568,89,97,2,3,0,3,3,3,4,"Low",-1,1
"6973",42,34,0,1.7107,106,97,3,3,0,4,4,4,4,"Low",0,0
"6974",42,35,0,1.063,84,67,4,3,0,0,0,0,4,"Low",1,1
"6975",42,36,1,1.4516,15,147,3,4,0,2,2,0,4,"Low",-1,1
"6976",42,37,0,0.76367,55,13,2,2,1,1,2,1,4,"Low",0,0
"6977",42,38,0,1.0983,55,38,2,4,2,0,2,0,4,"Low",-2,2
"6978",42,39,0,1.0039,116,134,1,3,0,0,0,0,4,"Low",-2,2
"6979",42,40,0,0.77464,134,6,3,6,1,0,1,0,4,"Low",-3,3
"6980",42,41,1,1.0946,98,80,3,4,1,0,1,1,4,"Low",-1,1
"6981",42,42,0,0.83557,101,94,3,5,1,0,1,0,4,"Low",-2,2
"6982",42,43,0,1.5599,70,3,7,7,1,0,1,0,4,"Low",0,0
"6983",42,44,0,1.1847,87,117,2,6,1,1,2,1,4,"Low",-4,4
"6984",42,45,1,1.2364,140,101,2,3,0,2,2,0,4,"Low",-1,1
"6985",42,46,0,0.71133,78,18,1,1,1,1,2,1,4,"Low",0,0
"6986",42,47,1,0.80195,100,144,4,2,0,2,2,0,4,"Low",2,2
"6987",42,48,1,0.91204,78,24,1,2,2,0,2,2,4,"Low",-1,1
"6988",42,49,1,1.0107,136,69,5,6,0,1,1,0,4,"Low",-1,1
"6989",42,50,0,0.69213,40,98,4,3,1,2,3,2,4,"Low",1,1
"6990",42,51,1,0.74613,105,40,2,4,2,2,4,2,4,"Low",-2,2
"6991",42,52,0,1.6022,1,19,5,7,0,1,1,1,4,"Low",-2,2
"6992",42,53,0,0.65366,72,117,5,6,2,2,4,2,4,"Low",-1,1
"6993",42,54,0,0.73107,115,105,6,2,1,3,4,3,4,"Low",4,4
"6994",42,55,0,1.0959,85,95,3,3,1,0,1,0,4,"Low",0,0
"6995",42,56,0,0.76459,48,117,6,6,0,3,3,3,4,"Low",0,0
"6996",42,57,0,1.3306,80,87,4,2,1,2,3,2,4,"Low",2,2
"6997",42,58,1,1.0274,110,63,5,2,1,0,1,1,4,"Low",3,3
"6998",42,59,0,0.71773,116,33,1,2,1,3,4,3,4,"Low",-1,1
"6999",42,60,1,0.97389,105,20,2,1,4,0,4,4,4,"Low",1,1
"7000",42,61,0,1.1433,118,127,2,4,2,0,2,0,4,"Low",-2,2
"7001",42,62,1,2.5727,34,84,5,4,0,1,1,0,4,"Low",1,1
"7002",42,63,1,1.0313,81,68,4,2,0,3,3,0,4,"Low",2,2
"7003",42,64,0,0.76496,45,129,3,2,0,0,0,0,4,"Low",1,1
"7004",42,65,0,1.2877,100,7,4,7,1,0,1,0,4,"Low",-3,3
"7005",42,66,0,1.2016,93,135,4,8,0,0,0,0,4,"Low",-4,4
"7006",42,67,0,1.0921,7,42,7,6,1,0,1,0,4,"Low",1,1
"7007",42,68,1,0.72312,82,124,2,2,0,1,1,0,4,"Low",0,0
"7008",42,69,1,1.769,27,82,1,2,0,1,1,0,4,"Low",-1,1
"7009",42,70,1,1.1925,138,83,6,2,1,3,4,1,4,"Low",4,4
"7010",42,71,1,2.1111,1,132,5,1,1,1,2,1,4,"Low",4,4
"7011",42,72,1,0.89789,16,10,6,4,0,3,3,0,4,"Low",2,2
"7012",42,73,0,1.1352,13,7,2,7,2,2,4,2,4,"Low",-5,5
"7013",42,74,1,0.86425,10,100,4,4,4,2,6,4,4,"High",0,0
"7014",42,75,0,0.7617,110,67,5,3,2,1,3,1,4,"Low",2,2
"7015",42,76,1,1.1934,94,77,5,1,1,1,2,1,4,"Low",4,4
"7016",42,77,0,2.1765,8,140,1,2,1,1,2,1,4,"Low",-1,1
"7017",42,78,1,0.6574,5,81,8,4,0,1,1,0,4,"Low",4,4
"7018",42,79,0,0.63804,55,43,2,3,3,0,3,0,4,"Low",-1,1
"7019",42,80,1,0.66337,12,31,1,5,0,0,0,0,4,"Low",-4,4
"7020",42,81,1,1.1309,37,89,2,2,1,1,2,1,4,"Low",0,0
"7021",42,82,0,0.92021,147,47,4,3,3,2,5,2,4,"High",1,1
"7022",42,83,1,1.1751,132,35,1,5,2,1,3,2,4,"Low",-4,4
"7023",42,84,1,1.179,138,63,6,2,2,1,3,2,4,"Low",4,4
"7024",42,85,1,0.6849,18,34,1,5,2,1,3,2,4,"Low",-4,4
"7025",42,86,1,0.66223,12,132,1,1,1,3,4,1,4,"Low",0,0
"7026",42,87,1,0.61111,48,27,6,1,1,1,2,1,4,"Low",5,5
"7027",42,88,1,1.2505,12,32,1,3,2,0,2,2,4,"Low",-2,2
"7028",42,89,1,1.2213,127,78,4,1,1,3,4,1,4,"Low",3,3
"7029",42,90,0,0.94375,12,95,1,3,3,1,4,1,4,"Low",-2,2
"7030",42,91,0,1.3605,53,4,4,1,0,0,0,0,4,"Low",3,3
"7031",42,92,0,1.1677,55,108,2,4,4,2,6,2,4,"High",-2,2
"7032",42,93,1,0.66586,133,65,4,3,0,0,0,0,4,"Low",1,1
"7033",42,94,1,0.69515,16,45,6,3,1,1,2,1,4,"Low",3,3
"7034",42,95,1,0.56279,141,48,4,6,1,2,3,1,4,"Low",-2,2
"7035",42,96,0,0.75271,83,111,2,2,4,0,4,0,4,"Low",0,0
"7036",42,97,1,0.53727,6,1,6,5,1,2,3,1,4,"Low",1,1
"7037",42,98,0,0.64887,63,134,2,3,2,2,4,2,4,"Low",-1,1
"7038",42,99,0,0.70945,40,47,4,3,3,3,6,3,4,"High",1,1
"7039",42,100,0,0.64226,34,72,5,5,2,3,5,3,4,"High",0,0
"7040",42,101,0,0.76225,65,69,3,6,1,2,3,2,4,"Low",-3,3
"7041",42,102,1,0.75369,44,31,5,5,0,1,1,0,4,"Low",0,0
"7042",42,103,0,0.64169,93,138,4,6,1,3,4,3,4,"Low",-2,2
"7043",42,104,0,1.2743,101,144,3,2,3,3,6,3,4,"High",1,1
"7044",42,105,0,0.76708,48,136,6,5,3,1,4,1,4,"Low",1,1
"7045",42,106,1,1.9145,18,133,1,4,3,1,4,3,4,"Low",-3,3
"7046",42,107,0,1.0584,41,43,2,3,0,1,1,1,4,"Low",-1,1
"7047",42,108,0,0.6132,147,7,4,7,4,3,7,3,4,"High",-3,3
"7048",42,109,1,1.1932,81,40,4,4,2,4,6,2,4,"High",0,0
"7049",42,110,1,0.95201,1,67,5,3,3,2,5,3,4,"High",2,2
"7050",42,111,0,0.6381,107,95,3,3,0,2,2,2,4,"Low",0,0
"7051",42,112,1,0.84667,107,18,3,1,1,4,5,1,4,"High",2,2
"7052",42,113,1,1.0168,11,85,1,3,1,2,3,1,4,"Low",-2,2
"7053",42,114,1,1.2689,114,53,3,4,2,1,3,2,4,"Low",-1,1
"7054",42,115,0,0.655,26,129,5,2,0,1,1,1,4,"Low",3,3
"7055",42,116,0,0.94414,8,136,1,5,2,2,4,2,4,"Low",-4,4
"7056",42,117,0,0.93558,63,77,2,1,3,2,5,2,4,"High",1,1
"7057",42,118,0,0.70175,98,1,3,5,3,4,7,4,4,"High",-2,2
"7058",42,119,0,1.3023,135,138,8,6,1,4,5,4,4,"High",2,2
"7059",42,120,0,0.77069,24,99,2,3,1,1,2,1,4,"Low",-1,1
"7060",42,121,1,0.71329,81,84,4,4,3,2,5,3,4,"High",0,0
"7061",42,122,1,0.83216,98,84,3,4,4,3,7,4,4,"High",-1,1
"7062",42,123,0,0.81795,53,43,4,3,2,2,4,2,4,"Low",1,1
"7063",42,124,1,1.1967,108,107,4,3,3,2,5,3,4,"High",1,1
"7064",42,125,0,1.262,69,42,6,6,3,1,4,1,4,"Low",0,0
"7065",42,126,0,0.92193,116,114,1,3,2,3,5,3,4,"High",-2,2
"7066",42,127,0,0.95609,48,142,6,8,4,0,4,0,4,"Low",-2,2
"7067",42,128,1,0.95749,93,100,4,4,2,3,5,2,4,"High",0,0
"7068",42,129,0,0.69952,126,107,5,3,0,3,3,3,4,"Low",2,2
"7069",42,130,1,1.2831,24,45,2,3,2,2,4,2,4,"Low",-1,1
"7070",42,131,1,1.7815,47,32,3,3,4,1,5,4,4,"High",0,0
"7071",42,132,1,1.0202,16,66,6,3,2,1,3,2,4,"Low",3,3
"7072",42,133,1,1.6734,72,20,5,1,4,1,5,4,4,"High",4,4
"7073",42,134,0,0.7472,45,66,3,3,3,2,5,2,4,"High",0,0
"7074",42,135,0,1.0095,32,19,3,7,2,2,4,2,4,"Low",-4,4
"7075",42,136,1,1.2225,15,27,3,1,1,2,3,1,4,"Low",2,2
"7076",42,137,0,1.7156,145,113,2,4,0,1,1,1,4,"Low",-2,2
"7077",42,138,0,1.1802,34,13,5,2,3,3,6,3,4,"High",3,3
"7078",42,139,0,1.6878,129,8,2,1,2,3,5,3,4,"High",1,1
"7079",42,140,0,0.94855,65,114,3,3,2,4,6,4,4,"High",0,0
"7080",42,141,1,0.94846,81,84,4,4,4,4,8,4,4,"High",0,0
"7081",42,142,1,0.84868,37,87,2,2,2,3,5,2,4,"High",0,0
"7082",42,143,1,1.7233,94,50,5,2,2,2,4,2,4,"Low",3,3
"7083",42,144,0,1.3061,80,5,4,8,2,1,3,1,4,"Low",-4,4
"7084",42,145,1,1.4615,132,77,1,1,4,3,7,4,4,"High",0,0
"7085",42,146,0,1.1213,99,42,3,6,2,2,4,2,4,"Low",-3,3
"7086",42,147,0,2.556,106,33,3,2,1,4,5,4,4,"High",1,1
"7087",42,148,0,2.2001,31,93,5,4,2,3,5,3,4,"High",1,1
"7088",42,149,1,1.6095,126,37,5,2,1,3,4,1,4,"Low",3,3
"7089",42,150,1,1.4924,31,133,5,4,3,2,5,3,4,"High",1,1
"7090",42,151,1,1.9895,20,67,1,3,2,3,5,2,4,"High",-2,2
"7091",42,152,0,1.1669,8,38,1,4,4,1,5,1,4,"High",-3,3
"7092",42,153,0,0.79768,89,144,2,2,2,4,6,4,4,"High",0,0
"7093",42,154,1,0.80128,26,30,5,3,1,1,2,1,4,"Low",2,2
"7094",42,155,0,0.97927,17,67,3,3,2,4,6,4,4,"High",0,0
"7095",42,156,0,0.64798,89,94,2,5,3,3,6,3,4,"High",-3,3
"7096",42,157,1,1.8406,34,45,5,3,4,4,8,4,4,"High",2,2
"7097",42,158,1,0.72623,30,87,3,2,2,4,6,2,4,"High",1,1
"7098",42,159,0,1.3921,115,95,6,3,2,3,5,3,4,"High",3,3
"7099",42,160,0,0.8023,78,37,1,2,4,4,8,4,4,"High",-1,1
"7100",42,161,0,0.86163,110,66,5,3,3,3,6,3,4,"High",2,2
"7101",42,162,0,0.8021,63,134,2,3,4,3,7,3,4,"High",-1,1
"7102",42,163,0,0.75819,4,69,1,6,1,4,5,4,4,"High",-5,5
"7103",42,164,0,1.1697,116,82,1,2,3,2,5,2,4,"High",-1,1
"7104",42,165,0,1.0012,66,12,3,1,4,4,8,4,4,"High",2,2
"7105",42,166,1,0.65854,3,80,7,4,1,3,4,1,4,"Low",3,3
"7106",42,167,0,0.78173,71,117,7,6,0,4,4,4,4,"Low",1,1
"7107",42,168,0,1.1072,101,28,3,3,4,1,5,1,4,"High",0,0
"7108",42,169,0,0.83555,111,7,2,7,1,4,5,4,4,"High",-5,5
"7109",42,170,0,0.74505,11,137,1,6,2,0,2,0,4,"Low",-5,5
"7110",42,171,0,0.66266,24,15,2,3,3,2,5,2,4,"High",-1,1
"7111",42,172,0,0.71004,15,70,3,7,3,2,5,2,4,"High",-4,4
"7112",42,173,1,0.7361,11,65,1,3,3,3,6,3,4,"High",-2,2
"7113",42,174,1,2.1528,30,82,3,2,3,3,6,3,4,"High",1,1
"7114",42,175,0,0.94076,20,108,1,4,3,4,7,4,4,"High",-3,3
"7115",42,176,1,1.3668,137,133,6,4,1,3,4,1,4,"Low",2,2
"7116",42,177,0,0.71037,17,6,3,6,3,2,5,2,4,"High",-3,3
"7117",42,178,1,1.7863,26,134,5,3,2,4,6,2,4,"High",2,2
"7118",42,179,1,1.0364,38,116,4,1,2,4,6,2,4,"High",3,3
"7119",42,180,0,1.4649,28,107,3,3,2,4,6,4,4,"High",0,0
"7120",42,181,1,0.69034,6,129,6,2,3,3,6,3,4,"High",4,4
"7121",42,182,1,1.1821,141,99,4,3,2,3,5,2,4,"High",1,1
"7122",42,183,0,0.91033,4,141,1,4,2,3,5,3,4,"High",-3,3
"7123",42,184,1,2.535,65,35,3,5,4,2,6,4,4,"High",-2,2
"7124",42,185,0,1.9269,85,30,3,3,3,4,7,4,4,"High",0,0
"7125",42,186,1,1.8637,13,93,2,4,4,4,8,4,4,"High",-2,2
"7126",42,187,1,0.99218,126,89,5,2,2,4,6,2,4,"High",3,3
"7127",42,188,0,1.5971,140,26,2,5,2,3,5,3,4,"High",-3,3
"7128",42,189,0,1.1128,11,16,1,6,4,3,7,3,4,"High",-5,5
"7129",42,190,0,1.017,32,16,3,6,3,4,7,4,4,"High",-3,3
"7130",42,191,0,2.0712,85,137,3,6,4,2,6,2,4,"High",-3,3
"7131",42,192,0,0.75467,82,127,2,4,4,2,6,2,4,"High",-2,2
"7132",42,193,0,0.7215,15,135,3,8,4,2,6,2,4,"High",-5,5
"7133",42,194,1,0.82145,106,124,3,2,2,2,4,2,4,"Low",1,1
"7134",42,195,1,1.6526,26,20,5,1,4,4,8,4,4,"High",4,4
"7135",42,196,0,1.0207,94,141,5,4,4,4,8,4,4,"High",1,1
"7136",42,197,1,0.96556,95,32,3,3,4,4,8,4,4,"High",0,0
"7137",42,198,1,0.96545,38,106,4,3,3,3,6,3,4,"High",1,1
"7138",42,199,1,0.65183,3,113,7,4,2,2,4,2,4,"Low",3,3
"7139",42,200,0,0.67843,80,99,4,3,4,4,8,4,4,"High",1,1
"7140",43,1,0,1.7968,11,14,2,1,0,0,0,0,4,"Low",1,1
"7141",43,2,1,5.7217,63,56,9,7,0,0,0,0,4,"Low",2,2
"7142",43,3,1,4.0045,103,130,2,2,0,0,0,0,4,"Low",0,0
"7143",43,4,0,2.2963,25,60,2,4,0,0,0,0,4,"Low",-2,2
"7144",43,5,1,3.9627,78,12,6,2,0,0,0,0,4,"Low",4,4
"7145",43,6,0,2.9152,119,5,3,3,0,0,0,0,4,"Low",0,0
"7146",43,7,1,2.2589,27,93,7,4,0,0,0,0,4,"Low",3,3
"7147",43,8,1,3.8268,32,142,8,3,0,0,0,0,4,"Low",5,5
"7148",43,9,1,3.021,136,58,5,3,0,0,0,0,4,"Low",2,2
"7149",43,10,1,2.2697,3,94,3,2,0,0,0,0,4,"Low",1,1
"7150",43,11,0,1.9338,58,146,3,3,1,0,1,0,4,"Low",0,0
"7151",43,12,0,3.063,52,24,7,8,0,0,0,0,4,"Low",-1,1
"7152",43,13,1,3.1991,72,24,8,8,0,1,1,0,4,"Low",0,0
"7153",43,14,0,2.9019,119,65,3,3,1,0,1,0,4,"Low",0,0
"7154",43,15,1,2.5992,117,102,7,2,0,0,0,0,4,"Low",5,5
"7155",43,16,0,3.0306,47,129,2,4,0,0,0,0,4,"Low",-2,2
"7156",43,17,1,1.558,18,128,9,4,0,0,0,0,4,"Low",5,5
"7157",43,18,0,1.8239,126,28,5,9,0,0,0,0,4,"Low",-4,4
"7158",43,19,1,2.9642,34,92,4,5,0,0,0,0,4,"Low",-1,1
"7159",43,20,0,3.3369,64,118,5,8,0,0,0,0,4,"Low",-3,3
"7160",43,21,0,4.2036,70,6,3,1,0,0,0,0,4,"Low",2,2
"7161",43,22,0,3.8584,102,136,2,5,1,1,2,1,4,"Low",-3,3
"7162",43,23,1,4.8898,136,124,5,1,2,0,2,2,4,"Low",4,4
"7163",43,24,0,3.5106,3,12,3,2,1,1,2,1,4,"Low",1,1
"7164",43,25,1,2.7212,5,100,3,1,1,0,1,1,4,"Low",2,2
"7165",43,26,1,3.3894,41,52,4,7,0,1,1,0,4,"Low",-3,3
"7166",43,27,0,4.4433,130,5,2,3,1,2,3,2,4,"Low",-1,1
"7167",43,28,1,8.1508,34,80,4,1,1,0,1,1,4,"Low",3,3
"7168",43,29,0,1.8757,64,122,5,4,1,0,1,0,4,"Low",1,1
"7169",43,30,1,1.5594,7,102,2,2,0,2,2,0,4,"Low",0,0
"7170",43,31,0,1.5815,146,60,3,4,1,1,2,1,4,"Low",-1,1
"7171",43,32,0,2.0115,136,104,5,9,3,0,3,0,4,"Low",-4,4
"7172",43,33,1,5.3715,128,145,4,8,1,0,1,1,4,"Low",-4,4
"7173",43,34,0,1.5597,108,18,4,9,0,1,1,1,4,"Low",-5,5
"7174",43,35,0,1.6059,93,27,4,7,1,1,2,1,4,"Low",-3,3
"7175",43,36,1,1.2506,27,129,7,4,2,1,3,2,4,"Low",3,3
"7176",43,37,1,1.5959,129,143,4,7,2,0,2,2,4,"Low",-3,3
"7177",43,38,0,1.7839,25,34,2,4,1,2,3,2,4,"Low",-2,2
"7178",43,39,0,1.7222,124,127,1,5,1,0,1,0,4,"Low",-4,4
"7179",43,40,1,5.0306,8,138,3,2,0,0,0,0,4,"Low",1,1
"7180",43,41,1,3.0514,17,93,1,4,0,2,2,0,4,"Low",-3,3
"7181",43,42,1,1.8686,12,101,2,2,2,0,2,2,4,"Low",0,0
"7182",43,43,1,1.5209,6,58,1,3,1,2,3,1,4,"Low",-2,2
"7183",43,44,0,2.8668,12,71,2,2,3,0,3,0,4,"Low",0,0
"7184",43,45,0,1.4571,19,56,3,7,0,1,1,1,4,"Low",-4,4
"7185",43,46,1,8.1294,146,3,3,3,2,2,4,2,4,"Low",0,0
"7186",43,47,1,1.5477,87,52,5,7,0,2,2,0,4,"Low",-2,2
"7187",43,48,1,2.3017,87,79,5,4,1,0,1,1,4,"Low",1,1
"7188",43,49,1,8.977,72,127,8,5,1,1,2,1,4,"Low",3,3
"7189",43,50,1,2.5266,17,64,1,5,1,2,3,1,4,"Low",-4,4
"7190",43,51,1,4.4198,93,47,4,2,3,1,4,3,4,"Low",2,2
"7191",43,52,0,3.0137,119,66,3,2,2,0,2,0,4,"Low",1,1
"7192",43,53,1,6.2385,61,23,4,8,0,0,0,0,4,"Low",-4,4
"7193",43,54,0,3.1972,146,136,3,5,3,4,7,4,4,"High",-2,2
"7194",43,55,1,1.8113,40,64,9,5,0,3,3,0,4,"Low",4,4
"7195",43,56,1,1.8893,41,145,4,8,1,1,2,1,4,"Low",-4,4
"7196",43,57,0,1.872,130,27,2,7,2,3,5,3,4,"High",-5,5
"7197",43,58,0,2.2769,130,77,2,2,3,0,3,0,4,"Low",0,0
"7198",43,59,0,2.4374,137,34,2,4,0,3,3,3,4,"Low",-2,2
"7199",43,60,1,1.9609,61,143,4,7,1,1,2,1,4,"Low",-3,3
"7200",43,61,1,3.4911,64,7,5,2,4,1,5,4,4,"High",3,3
"7201",43,62,1,1.4064,128,93,4,4,2,4,6,2,4,"High",0,0
"7202",43,63,1,3.2977,129,126,4,5,3,1,4,3,4,"Low",-1,1
"7203",43,64,1,1.3099,141,105,10,8,0,0,0,0,4,"Low",2,2
"7204",43,65,0,5.4873,105,104,8,9,1,1,2,1,4,"Low",-1,1
"7205",43,66,0,1.9607,115,28,6,9,0,1,1,1,4,"Low",-3,3
"7206",43,67,0,14.9124,134,79,9,4,0,1,1,1,4,"Low",5,5
"7207",43,68,0,2.638,19,78,3,6,1,1,2,1,4,"Low",-3,3
"7208",43,69,1,1.1862,17,137,1,2,2,1,3,2,4,"Low",-1,1
"7209",43,70,1,2.24,12,34,2,4,4,4,8,4,4,"High",-2,2
"7210",43,71,0,1.4381,143,58,7,3,2,3,5,3,4,"High",4,4
"7211",43,72,0,1.8588,17,100,1,1,3,1,4,1,4,"Low",0,0
"7212",43,73,1,2.3385,102,4,2,2,3,0,3,3,4,"Low",0,0
"7213",43,74,1,24.0354,79,106,4,5,2,0,2,2,4,"Low",-1,1
"7214",43,75,0,1.6768,72,33,8,10,2,0,2,0,4,"Low",-2,2
"7215",43,76,1,3.08,134,122,9,4,1,1,2,1,4,"Low",5,5
"7216",43,77,1,1.264,44,108,2,4,0,1,1,0,4,"Low",-2,2
"7217",43,78,1,3.7148,24,142,8,3,2,1,3,2,4,"Low",5,5
"7218",43,79,0,2.3355,127,100,5,1,2,2,4,2,4,"Low",4,4
"7219",43,80,0,1.0237,103,87,2,5,1,2,3,2,4,"Low",-3,3
"7220",43,81,1,1.7176,6,129,1,4,2,4,6,2,4,"High",-3,3
"7221",43,82,1,3.4897,127,101,5,2,3,1,4,3,4,"Low",3,3
"7222",43,83,0,2.0425,137,102,2,2,2,4,6,4,4,"High",0,0
"7223",43,84,1,2.9005,105,52,8,7,2,3,5,2,4,"High",1,1
"7224",43,85,1,10.4777,32,3,8,3,1,3,4,1,4,"Low",5,5
"7225",43,86,1,2.4754,128,80,4,1,3,1,4,3,4,"Low",3,3
"7226",43,87,0,2.1272,145,33,8,10,2,1,3,1,4,"Low",-2,2
"7227",43,88,0,1.9207,116,106,6,5,0,1,1,1,4,"Low",1,1
"7228",43,89,0,2.6846,68,71,2,2,0,1,1,1,4,"Low",0,0
"7229",43,90,0,1.3687,78,23,6,8,2,1,3,1,4,"Low",-2,2
"7230",43,91,1,2.6574,4,84,2,1,1,0,1,1,4,"Low",1,1
"7231",43,92,1,1.819,89,6,1,1,0,3,3,0,4,"Low",0,0
"7232",43,93,0,2.1891,118,33,8,10,1,2,3,2,4,"Low",-2,2
"7233",43,94,0,3.1929,11,25,2,2,1,2,3,2,4,"Low",0,0
"7234",43,95,1,1.7442,23,143,8,7,2,3,5,2,4,"High",1,1
"7235",43,96,1,2.1923,8,119,3,3,1,3,4,1,4,"Low",0,0
"7236",43,97,1,7.1522,65,35,3,4,1,0,1,1,4,"Low",-1,1
"7237",43,98,0,2.3411,130,69,2,2,4,0,4,0,4,"Low",0,0
"7238",43,99,0,2.7931,6,5,1,3,4,3,7,3,4,"High",-2,2
"7239",43,100,1,1.4006,79,25,4,2,3,3,6,3,4,"High",2,2
"7240",43,101,1,0.84384,61,83,4,1,2,0,2,2,4,"Low",3,3
"7241",43,102,0,1.2406,108,70,4,3,2,1,3,1,4,"Low",1,1
"7242",43,103,0,3.536,100,77,1,2,3,1,4,1,4,"Low",-1,1
"7243",43,104,1,1.2756,107,11,2,2,0,2,2,0,4,"Low",0,0
"7244",43,105,0,1.6897,108,142,4,3,3,2,5,2,4,"High",1,1
"7245",43,106,0,5.7481,92,60,5,4,1,2,3,2,4,"Low",1,1
"7246",43,107,0,1.2657,146,41,3,4,4,2,6,2,4,"High",-1,1
"7247",43,108,0,5.5455,94,115,2,6,1,1,2,1,4,"Low",-4,4
"7248",43,109,1,2.2304,79,3,4,3,4,4,8,4,4,"High",1,1
"7249",43,110,1,1.4478,141,104,10,9,1,2,3,1,4,"Low",1,1
"7250",43,111,1,1.6439,8,19,3,3,2,2,4,2,4,"Low",0,0
"7251",43,112,0,4.5184,103,58,2,3,2,4,6,4,4,"High",-1,1
"7252",43,113,0,1.3567,104,56,9,7,3,2,5,2,4,"High",2,2
"7253",43,114,1,2.3298,134,35,9,4,2,1,3,2,4,"Low",5,5
"7254",43,115,1,1.5422,14,19,1,3,1,3,4,1,4,"Low",-2,2
"7255",43,116,0,1.7628,41,28,4,9,3,2,5,2,4,"High",-5,5
"7256",43,117,1,2.4793,60,14,4,1,3,2,5,3,4,"High",3,3
"7257",43,118,1,2.0094,65,142,3,3,2,3,5,2,4,"High",0,0
"7258",43,119,0,4.1008,125,138,1,2,0,1,1,1,4,"Low",-1,1
"7259",43,120,0,2.5217,61,106,4,5,3,2,5,2,4,"High",-1,1
"7260",43,121,1,1.321,72,5,8,3,3,4,7,3,4,"High",5,5
"7261",43,122,1,1.1336,87,65,5,3,3,3,6,3,4,"High",2,2
"7262",43,123,0,2.0065,126,69,5,2,2,1,3,1,4,"Low",3,3
"7263",43,124,0,2.293,35,48,4,3,2,0,2,0,4,"Low",1,1
"7264",43,125,0,5.1153,126,43,5,6,3,0,3,0,4,"Low",-1,1
"7265",43,126,0,1.7006,92,119,5,3,2,4,6,4,4,"High",2,2
"7266",43,127,1,1.9388,104,117,9,7,4,1,5,4,4,"High",2,2
"7267",43,128,1,1.6335,118,48,8,3,2,1,3,2,4,"Low",5,5
"7268",43,129,1,2.8634,11,108,2,4,3,4,7,3,4,"High",-2,2
"7269",43,130,1,2.4036,61,138,4,2,4,2,6,4,4,"High",2,2
"7270",43,131,0,2.4723,4,52,2,7,2,4,6,4,4,"High",-5,5
"7271",43,132,0,6.9795,103,56,2,7,3,3,6,3,4,"High",-5,5
"7272",43,133,1,2.1973,100,25,1,2,4,4,8,4,4,"High",-1,1
"7273",43,134,0,1.1514,142,32,3,8,4,2,6,2,4,"High",-5,5
"7274",43,135,0,1.7225,87,27,5,7,4,4,8,4,4,"High",-2,2
"7275",43,136,0,6.9205,43,23,6,8,1,3,4,3,4,"Low",-2,2
"7276",43,137,0,4.062,115,65,6,3,2,4,6,4,4,"High",3,3
"7277",43,138,0,7.7927,138,107,2,2,3,1,4,1,4,"Low",0,0
"7278",43,139,0,1.6163,7,122,2,4,2,2,4,2,4,"Low",-2,2
"7279",43,140,0,4.6155,28,105,9,8,3,3,6,3,4,"High",1,1
"7280",43,141,0,6.1616,66,84,2,1,1,1,2,1,4,"Low",1,1
"7281",43,142,1,1.7139,84,68,1,2,2,1,3,2,4,"Low",-1,1
"7282",43,143,0,2.3393,80,43,1,6,2,2,4,2,4,"Low",-5,5
"7283",43,144,0,1.4139,131,122,6,4,0,3,3,3,4,"Low",2,2
"7284",43,145,0,1.25,17,128,1,4,4,4,8,4,4,"High",-3,3
"7285",43,146,0,1.8969,63,141,9,10,1,2,3,2,4,"Low",-1,1
"7286",43,147,1,2.0735,106,84,5,1,3,3,6,3,4,"High",4,4
"7287",43,148,1,6.6617,127,48,5,3,4,2,6,4,4,"High",2,2
"7288",43,149,1,1.9925,118,70,8,3,3,2,5,3,4,"High",5,5
"7289",43,150,1,3.4489,42,115,7,6,0,3,3,0,4,"Low",1,1
"7290",43,151,0,2.2625,126,56,5,7,4,4,8,4,4,"High",-2,2
"7291",43,152,1,1.671,122,7,4,2,4,3,7,4,4,"High",2,2
"7292",43,153,0,1.6384,84,131,1,6,4,1,5,1,4,"High",-5,5
"7293",43,154,0,3.2192,124,71,1,2,2,2,4,2,4,"Low",-1,1
"7294",43,155,0,5.6858,43,107,6,2,3,2,5,2,4,"High",4,4
"7295",43,156,1,1.3774,33,117,10,7,3,2,5,3,4,"High",3,3
"7296",43,157,0,2.7359,43,23,6,8,4,4,8,4,4,"High",-2,2
"7297",43,158,0,4.1315,4,143,2,7,3,4,7,4,4,"High",-5,5
"7298",43,159,1,1.0349,107,19,2,3,3,4,7,3,4,"High",-1,1
"7299",43,160,0,1.2673,101,89,2,1,2,1,3,1,4,"Low",1,1
"7300",43,161,1,1.3383,18,141,9,10,2,3,5,2,4,"High",-1,1
"7301",43,162,0,0.68492,106,33,5,10,4,4,8,4,4,"High",-5,5
"7302",43,163,0,3.2329,137,70,2,3,3,3,6,3,4,"High",-1,1
"7303",43,164,0,0.91835,69,80,2,1,2,3,5,3,4,"High",1,1
"7304",43,165,0,0.8366,4,115,2,6,4,4,8,4,4,"High",-4,4
"7305",43,166,1,16.873,80,70,1,3,4,4,8,4,4,"High",-2,2
"7306",43,167,1,1.354,32,78,8,6,3,3,6,3,4,"High",2,2
"7307",43,168,1,1.5927,41,11,4,2,4,4,8,4,4,"High",2,2
"7308",43,169,1,4.6821,7,48,2,3,4,3,7,4,4,"High",-1,1
"7309",43,170,1,1.0768,117,94,7,2,3,2,5,3,4,"High",5,5
"7310",43,171,0,1.0809,92,66,5,2,3,2,5,2,4,"High",3,3
"7311",43,172,0,8.7389,14,107,1,2,3,4,7,4,4,"High",-1,1
"7312",43,173,0,1.9831,137,138,2,2,4,4,8,4,4,"High",0,0
"7313",43,174,0,1.0577,89,60,1,4,2,4,6,4,4,"High",-3,3
"7314",43,175,0,1.2458,32,63,8,9,4,2,6,2,4,"High",-1,1
"7315",43,176,0,1.1452,8,105,3,8,3,4,7,4,4,"High",-5,5
"7316",43,177,1,1.5959,131,89,6,1,2,3,5,2,4,"High",5,5
"7317",43,178,0,1.3372,8,47,3,2,4,2,6,2,4,"High",1,1
"7318",43,179,0,2.0146,89,125,1,1,4,1,5,1,4,"High",0,0
"7319",43,180,0,5.5995,131,83,6,1,3,1,4,1,4,"Low",5,5
"7320",43,181,1,0.94682,18,28,9,9,3,4,7,3,4,"High",0,0
"7321",43,182,0,0.8095,42,77,7,2,1,2,3,2,4,"Low",5,5
"7322",43,183,1,2.547,66,125,2,1,3,2,5,3,4,"High",1,1
"7323",43,184,0,1.993,103,66,2,2,4,4,8,4,4,"High",0,0
"7324",43,185,1,4.5098,116,77,6,2,1,3,4,1,4,"Low",4,4
"7325",43,186,0,1.0001,78,48,6,3,4,4,8,4,4,"High",3,3
"7326",43,187,1,1.6826,35,94,4,2,3,3,6,3,4,"High",2,2
"7327",43,188,0,1.1734,125,83,1,1,3,2,5,2,4,"High",0,0
"7328",43,189,1,5.8813,124,92,1,5,3,4,7,3,4,"High",-4,4
"7329",43,190,0,1.0777,145,35,8,4,3,4,7,4,4,"High",4,4
"7330",43,191,1,1.3955,94,125,2,1,4,4,8,4,4,"High",1,1
"7331",43,192,0,1.2863,72,141,8,10,4,4,8,4,4,"High",-2,2
"7332",43,193,0,3.9056,47,124,2,1,3,4,7,4,4,"High",1,1
"7333",43,194,0,1.4349,18,134,9,9,4,3,7,3,4,"High",0,0
"7334",43,195,0,1.342,71,117,2,7,3,4,7,4,4,"High",-5,5
"7335",43,196,0,1.1852,69,44,2,2,3,1,4,1,4,"Low",0,0
"7336",43,197,1,1.1824,131,68,6,2,4,2,6,4,4,"High",4,4
"7337",43,198,1,6.4045,14,83,1,1,4,3,7,4,4,"High",0,0
"7338",43,199,0,1.0845,145,42,8,7,4,2,6,2,4,"High",1,1
"7339",43,200,1,13.5424,118,134,8,9,4,4,8,4,4,"High",-1,1
"7340",44,1,1,0.82676,71,18,3,2,0,0,0,0,4,"Low",1,1
"7341",44,2,1,1.0473,48,56,4,6,0,0,0,0,4,"Low",-2,2
"7342",44,3,1,0.84459,70,112,4,5,0,0,0,0,4,"Low",-1,1
"7343",44,4,0,2.3046,113,61,2,4,0,0,0,0,4,"Low",-2,2
"7344",44,5,1,1.2194,44,127,4,4,0,0,0,0,4,"Low",0,0
"7345",44,6,0,0.73026,17,56,2,6,0,1,1,1,4,"Low",-4,4
"7346",44,7,1,0.62813,61,48,4,4,1,1,2,1,4,"Low",0,0
"7347",44,8,1,0.72402,33,142,5,4,0,0,0,0,4,"Low",1,1
"7348",44,9,1,1.0708,49,5,6,7,0,0,0,0,4,"Low",-1,1
"7349",44,10,1,0.81791,101,100,6,1,0,0,0,0,4,"Low",5,5
"7350",44,11,1,1.2743,107,69,8,5,0,0,0,0,4,"Low",3,3
"7351",44,12,1,2.1103,146,118,3,3,0,0,0,0,4,"Low",0,0
"7352",44,13,1,3.2003,43,96,4,4,0,0,0,0,4,"Low",0,0
"7353",44,14,1,0.74983,123,32,2,3,0,0,0,0,4,"Low",-1,1
"7354",44,15,1,1.4408,117,105,3,2,0,0,0,0,4,"Low",1,1
"7355",44,16,1,1.2883,24,17,3,2,0,1,1,0,4,"Low",1,1
"7356",44,17,1,1.173,33,103,5,3,1,0,1,1,4,"Low",2,2
"7357",44,18,1,1.9711,19,134,6,2,0,0,0,0,4,"Low",4,4
"7358",44,19,0,1.8192,96,23,4,5,1,0,1,0,4,"Low",-1,1
"7359",44,20,1,4.0581,112,31,5,2,1,0,1,1,4,"Low",3,3
"7360",44,21,0,1.4167,118,69,3,5,1,1,2,1,4,"Low",-2,2
"7361",44,22,0,1.6459,17,137,2,6,2,0,2,0,4,"Low",-4,4
"7362",44,23,0,1.2665,97,71,2,3,0,1,1,1,4,"Low",-1,1
"7363",44,24,0,1.528,129,70,2,4,0,1,1,1,4,"Low",-2,2
"7364",44,25,0,1.1142,31,47,2,6,1,0,1,0,4,"Low",-4,4
"7365",44,26,0,2.1715,136,105,1,2,0,1,1,1,4,"Low",-1,1
"7366",44,27,1,0.82849,69,25,5,3,2,0,2,2,4,"Low",2,2
"7367",44,28,1,0.81942,141,84,5,6,0,0,0,0,4,"Low",-1,1
"7368",44,29,1,2.5683,93,38,3,4,0,0,0,0,4,"Low",-1,1
"7369",44,30,1,2.2337,142,27,4,5,1,0,1,1,4,"Low",-1,1
"7370",44,31,0,1.0953,29,38,2,4,0,1,1,1,4,"Low",-2,2
"7371",44,32,0,0.85513,29,35,2,6,1,0,1,0,4,"Low",-4,4
"7372",44,33,0,2.0516,55,126,1,3,0,0,0,0,4,"Low",-2,2
"7373",44,34,1,1.0505,33,107,5,8,2,1,3,2,4,"Low",-3,3
"7374",44,35,1,3.3244,117,128,3,2,1,0,1,1,4,"Low",1,1
"7375",44,36,0,1.4547,96,70,4,4,2,2,4,2,4,"Low",0,0
"7376",44,37,1,1.2441,96,134,4,2,3,1,4,3,4,"Low",2,2
"7377",44,38,0,1.2968,56,61,6,4,2,2,4,2,4,"Low",2,2
"7378",44,39,1,0.97217,25,17,3,2,1,3,4,1,4,"Low",1,1
"7379",44,40,1,1.0957,131,34,6,3,0,0,0,0,4,"Low",3,3
"7380",44,41,1,1.2987,112,56,5,6,2,3,5,2,4,"High",-1,1
"7381",44,42,1,2.2315,36,28,6,4,0,0,0,0,4,"Low",2,2
"7382",44,43,0,1.3747,146,103,3,3,1,1,2,1,4,"Low",0,0
"7383",44,44,1,1.0537,56,63,6,4,4,0,4,4,4,"Low",2,2
"7384",44,45,1,1.5464,19,32,6,3,1,1,2,1,4,"Low",3,3
"7385",44,46,1,1.5764,38,54,4,1,2,0,2,2,4,"Low",3,3
"7386",44,47,1,2.3358,106,58,4,6,0,0,0,0,4,"Low",-2,2
"7387",44,48,1,0.6969,68,27,2,5,0,1,1,0,4,"Low",-3,3
"7388",44,49,0,2.6765,17,127,2,4,4,1,5,1,4,"High",-2,2
"7389",44,50,1,0.96446,69,63,5,4,3,1,4,3,4,"Low",1,1
"7390",44,51,0,1.072,101,49,6,6,1,1,2,1,4,"Low",0,0
"7391",44,52,1,1.5974,106,126,4,3,1,1,2,1,4,"Low",1,1
"7392",44,53,1,0.91747,42,97,1,2,0,1,1,0,4,"Low",-1,1
"7393",44,54,0,0.96814,102,84,3,6,0,1,1,1,4,"Low",-3,3
"7394",44,55,1,1.1907,124,136,6,1,0,1,1,0,4,"Low",5,5
"7395",44,56,1,1.1671,123,28,2,4,1,1,2,1,4,"Low",-2,2
"7396",44,57,1,0.95101,95,35,7,6,0,1,1,0,4,"Low",1,1
"7397",44,58,0,1.3064,77,49,3,6,0,2,2,2,4,"Low",-3,3
"7398",44,59,1,1.1809,104,93,3,3,0,1,1,0,4,"Low",0,0
"7399",44,60,1,1.1644,12,28,8,4,0,2,2,0,4,"Low",4,4
"7400",44,61,0,1.0935,87,112,3,5,0,3,3,3,4,"Low",-2,2
"7401",44,62,1,1.0993,35,28,6,4,2,3,5,2,4,"High",2,2
"7402",44,63,1,0.78438,124,32,6,3,1,2,3,1,4,"Low",3,3
"7403",44,64,0,1.2663,24,52,3,6,1,0,1,0,4,"Low",-3,3
"7404",44,65,0,1.6873,112,23,5,5,4,1,5,1,4,"High",0,0
"7405",44,66,1,1.4814,104,32,3,3,1,3,4,1,4,"Low",0,0
"7406",44,67,0,0.82655,27,141,5,5,2,1,3,1,4,"Low",0,0
"7407",44,68,1,1.0551,43,118,4,3,1,2,3,1,4,"Low",1,1
"7408",44,69,1,0.90672,137,100,6,1,1,1,2,1,4,"Low",5,5
"7409",44,70,0,1.3053,119,77,2,3,0,1,1,1,4,"Low",-1,1
"7410",44,71,1,1.2722,44,94,4,2,1,0,1,1,4,"Low",2,2
"7411",44,72,1,1.2934,122,113,4,2,0,1,1,0,4,"Low",2,2
"7412",44,73,0,0.81208,67,137,1,6,0,2,2,2,4,"Low",-5,5
"7413",44,74,0,1.0452,35,141,6,5,3,2,5,2,4,"High",1,1
"7414",44,75,1,0.80476,141,129,5,2,3,1,4,3,4,"Low",3,3
"7415",44,76,0,0.99436,143,84,4,6,0,2,2,2,4,"Low",-2,2
"7416",44,77,0,1.1469,27,123,5,2,3,2,5,2,4,"High",3,3
"7417",44,78,0,2.0438,32,131,3,6,4,1,5,1,4,"High",-3,3
"7418",44,79,0,1.0869,136,96,1,4,2,4,6,4,4,"High",-3,3
"7419",44,80,0,1.0185,25,31,3,2,2,2,4,2,4,"Low",1,1
"7420",44,81,0,1.0218,22,18,3,2,0,1,1,1,4,"Low",1,1
"7421",44,82,0,0.78801,97,49,2,6,2,3,5,3,4,"High",-4,4
"7422",44,83,0,1.5146,134,129,2,2,2,2,4,2,4,"Low",0,0
"7423",44,84,0,1.4954,28,143,4,4,4,1,5,1,4,"High",0,0
"7424",44,85,0,1.6516,119,49,2,6,1,4,5,4,4,"High",-4,4
"7425",44,86,0,1.5061,12,91,8,8,1,0,1,0,4,"Low",0,0
"7426",44,87,1,1.6147,5,87,7,3,1,1,2,1,4,"Low",4,4
"7427",44,88,1,1.365,74,55,2,1,0,1,1,0,4,"Low",1,1
"7428",44,89,0,1.8676,105,143,2,4,2,2,4,2,4,"Low",-2,2
"7429",44,90,0,1.0125,72,36,5,6,0,1,1,1,4,"Low",-1,1
"7430",44,91,1,1.049,36,74,6,2,2,1,3,2,4,"Low",4,4
"7431",44,92,1,1.1961,102,67,3,1,1,1,2,1,4,"Low",2,2
"7432",44,93,0,1.0799,103,36,3,6,2,3,5,3,4,"High",-3,3
"7433",44,94,0,1.7471,118,128,3,2,3,1,4,1,4,"Low",1,1
"7434",44,95,1,1.0651,79,118,7,3,0,4,4,0,4,"Low",4,4
"7435",44,96,1,1.2677,143,93,4,3,3,2,5,3,4,"High",1,1
"7436",44,97,0,1.4626,54,36,1,6,1,4,5,4,4,"High",-5,5
"7437",44,98,1,0.66778,61,102,4,3,3,2,5,3,4,"High",1,1
"7438",44,99,0,1.2944,5,84,7,6,2,3,5,3,4,"High",1,1
"7439",44,100,1,1.3177,31,34,2,3,3,1,4,3,4,"Low",-1,1
"7440",44,101,0,1.108,104,69,3,5,2,4,6,4,4,"High",-2,2
"7441",44,102,0,1.6522,34,123,3,2,2,3,5,3,4,"High",1,1
"7442",44,103,1,1.1461,72,131,5,6,1,2,3,1,4,"Low",-1,1
"7443",44,104,1,2.5621,142,111,4,5,2,0,2,2,4,"Low",-1,1
"7444",44,105,1,0.99955,124,131,6,6,2,3,5,2,4,"High",0,0
"7445",44,106,1,0.82794,136,113,1,2,3,2,5,3,4,"High",-1,1
"7446",44,107,0,1.2732,68,61,2,4,1,4,5,4,4,"High",-2,2
"7447",44,108,1,1.3939,129,29,2,2,3,2,5,3,4,"High",0,0
"7448",44,109,0,1.063,129,95,2,7,4,1,5,1,4,"High",-5,5
"7449",44,110,0,1.4024,97,23,2,5,3,2,5,2,4,"High",-3,3
"7450",44,111,1,0.93546,117,146,3,3,2,2,4,2,4,"Low",0,0
"7451",44,112,0,1.1987,34,71,3,3,3,2,5,2,4,"High",0,0
"7452",44,113,0,1.856,38,70,4,4,3,3,6,3,4,"High",0,0
"7453",44,114,0,0.62335,146,23,3,5,3,3,6,3,4,"High",-2,2
"7454",44,115,1,1.4125,111,18,5,2,1,2,3,1,4,"Low",3,3
"7455",44,116,1,1.7475,72,29,5,2,2,3,5,2,4,"High",3,3
"7456",44,117,0,1.6382,100,134,1,2,2,3,5,3,4,"High",-1,1
"7457",44,118,1,1.1529,77,123,3,2,2,4,6,2,4,"High",1,1
"7458",44,119,0,0.69814,87,141,3,5,2,4,6,4,4,"High",-2,2
"7459",44,120,1,1.1002,145,22,5,3,0,1,1,0,4,"Low",2,2
"7460",44,121,1,1.6462,5,77,7,3,3,3,6,3,4,"High",4,4
"7461",44,122,1,1.0355,48,103,4,3,2,3,5,2,4,"High",1,1
"7462",44,123,1,1.1079,33,87,5,3,3,3,6,3,4,"High",2,2
"7463",44,124,0,0.83028,119,71,2,3,2,3,5,3,4,"High",-1,1
"7464",44,125,0,2.4206,12,43,8,4,2,2,4,2,4,"Low",4,4
"7465",44,126,0,1.0738,34,27,3,5,4,4,8,4,4,"High",-2,2
"7466",44,127,0,1.5682,104,107,3,8,3,2,5,2,4,"High",-5,5
"7467",44,128,0,0.95,93,47,3,6,3,1,4,1,4,"Low",-3,3
"7468",44,129,0,1.1764,38,68,4,2,4,2,6,2,4,"High",2,2
"7469",44,130,1,2.7717,71,117,3,3,4,3,7,4,4,"High",0,0
"7470",44,131,1,0.8636,24,103,3,3,2,4,6,2,4,"High",0,0
"7471",44,132,0,1.4033,105,134,2,2,3,4,7,4,4,"High",0,0
"7472",44,133,0,2.1099,95,33,7,5,2,4,6,4,4,"High",2,2
"7473",44,134,1,1.2041,63,107,4,8,2,3,5,2,4,"High",-4,4
"7474",44,135,0,2.1247,93,54,3,1,4,2,6,2,4,"High",2,2
"7475",44,136,0,1.6664,113,68,2,2,3,3,6,3,4,"High",0,0
"7476",44,137,1,1.065,124,79,6,7,3,1,4,3,4,"Low",-1,1
"7477",44,138,0,0.99714,29,74,2,2,4,2,6,2,4,"High",0,0
"7478",44,139,0,2.2442,22,18,3,2,2,3,5,3,4,"High",1,1
"7479",44,140,0,1.2984,122,72,4,5,1,3,4,3,4,"Low",-1,1
"7480",44,141,1,1.4365,128,131,2,6,2,4,6,2,4,"High",-4,4
"7481",44,142,0,1.5147,77,48,3,4,4,3,7,3,4,"High",-1,1
"7482",44,143,0,2.2946,12,58,8,6,3,1,4,1,4,"Low",2,2
"7483",44,144,0,1.0911,55,143,1,4,2,4,6,4,4,"High",-3,3
"7484",44,145,1,0.92706,23,137,5,6,4,3,7,4,4,"High",-1,1
"7485",44,146,0,1.14,63,122,4,4,3,2,5,2,4,"High",0,0
"7486",44,147,1,1.3412,117,113,3,2,4,4,8,4,4,"High",1,1
"7487",44,148,0,1.2922,72,88,5,8,4,0,4,0,4,"Low",-3,3
"7488",44,149,0,0.90621,105,101,2,6,4,2,6,2,4,"High",-4,4
"7489",44,150,0,1.6361,106,79,4,7,2,2,4,2,4,"Low",-3,3
"7490",44,151,0,1.2962,101,70,6,4,3,4,7,4,4,"High",2,2
"7491",44,152,0,1.2776,126,88,3,8,2,1,3,1,4,"Low",-5,5
"7492",44,153,1,1.1241,44,124,4,6,2,4,6,2,4,"High",-2,2
"7493",44,154,1,0.83836,24,127,3,4,3,2,5,3,4,"High",-1,1
"7494",44,155,1,0.86124,68,102,2,3,4,3,7,4,4,"High",-1,1
"7495",44,156,0,2.0662,128,43,2,4,3,3,6,3,4,"High",-2,2
"7496",44,157,1,0.859,107,146,8,3,4,4,8,4,4,"High",5,5
"7497",44,158,1,1.255,5,24,7,3,4,4,8,4,4,"High",4,4
"7498",44,159,1,1.005,79,18,7,2,3,4,7,3,4,"High",5,5
"7499",44,160,1,1.3345,128,97,2,2,4,4,8,4,4,"High",0,0
"7500",44,161,1,1.2333,88,48,8,4,2,4,6,2,4,"High",4,4
"7501",44,162,0,0.99965,100,43,1,4,3,4,7,4,4,"High",-3,3
"7502",44,163,1,1.1744,100,74,1,2,4,3,7,4,4,"High",-1,1
"7503",44,164,0,0.88601,63,136,4,1,4,4,8,4,4,"High",3,3
"7504",44,165,0,0.69796,137,88,6,8,4,3,7,3,4,"High",-2,2
"7505",44,166,1,1.1898,42,25,1,3,1,3,4,1,4,"Low",-2,2
"7506",44,167,0,1.182,126,58,3,6,3,2,5,2,4,"High",-3,3
"7507",44,168,0,1.19,111,31,5,2,2,4,6,4,4,"High",3,3
"7508",44,169,1,0.94418,55,66,1,2,3,0,3,3,4,"Low",-1,1
"7509",44,170,1,1.3233,58,94,6,2,3,1,4,3,4,"Low",4,4
"7510",44,171,1,1.0854,142,122,4,4,3,3,6,3,4,"High",0,0
"7511",44,172,1,0.69658,44,126,4,3,3,4,7,3,4,"High",1,1
"7512",44,173,1,0.99477,52,66,6,2,1,1,2,1,4,"Low",4,4
"7513",44,174,1,1.0436,102,122,3,4,4,4,8,4,4,"High",-1,1
"7514",44,175,1,2.7055,127,106,4,4,3,3,6,3,4,"High",0,0
"7515",44,176,1,2.1424,44,142,4,4,4,4,8,4,4,"High",0,0
"7516",44,177,0,0.78353,66,101,2,6,2,4,6,4,4,"High",-4,4
"7517",44,178,1,0.78766,25,35,3,6,4,4,8,4,4,"High",-3,3
"7518",44,179,1,2.0902,94,106,2,4,2,4,6,2,4,"High",-2,2
"7519",44,180,0,1.1523,104,79,3,7,4,4,8,4,4,"High",-4,4
"7520",44,181,0,1.3992,74,22,2,3,4,3,7,3,4,"High",-1,1
"7521",44,182,0,1.5146,19,47,6,6,2,2,4,2,4,"Low",0,0
"7522",44,183,0,0.90118,119,145,2,5,3,1,4,1,4,"Low",-3,3
"7523",44,184,0,1.4754,66,111,2,5,3,3,6,3,4,"High",-3,3
"7524",44,185,1,0.94531,84,127,6,4,4,4,8,4,4,"High",2,2
"7525",44,186,1,1.4109,58,55,6,1,4,4,8,4,4,"High",5,5
"7526",44,187,1,0.80152,47,52,6,6,3,2,5,3,4,"High",0,0
"7527",44,188,1,1.0787,52,111,6,5,3,4,7,3,4,"High",1,1
"7528",44,189,1,1.2094,87,145,3,5,4,2,6,4,4,"High",-2,2
"7529",44,190,0,1.1844,12,52,8,6,4,4,8,4,4,"High",2,2
"7530",44,191,1,0.59818,47,67,6,1,4,2,6,4,4,"High",5,5
"7531",44,192,0,1.1255,67,42,1,1,3,2,5,2,4,"High",0,0
"7532",44,193,1,0.75237,145,22,5,3,3,4,7,3,4,"High",2,2
"7533",44,194,1,0.65034,94,54,2,1,3,3,6,3,4,"High",1,1
"7534",44,195,1,1.4605,42,54,1,1,3,4,7,3,4,"High",0,0
"7535",44,196,1,1.0237,94,67,2,1,4,4,8,4,4,"High",1,1
"7536",44,197,0,2.1065,91,83,8,8,1,0,1,0,4,"Low",0,0
"7537",44,198,1,0.82689,95,66,7,2,3,4,7,3,4,"High",5,5
"7538",44,199,0,0.92851,19,42,6,1,3,4,7,4,4,"High",5,5
"7539",44,200,1,0.89787,83,95,8,7,1,4,5,1,4,"High",1,1
